AAAGCACC	AAGCACCC
AAAGCACG	AAAGCTCG
AACCTAAA	CAACCTAA
AACCTAAC	CAACCTAA
AACCTAAT	CAACCTAA
AACCTAAG	CAACCTAA
AACCTAAN	CAACCTAA
ATGAGACT	TGAGACTA
ATNTACAG	ATTACAGG
AAAGCATC	AAAGCTCG
AAAAAATC	TAAAAATC
ACCTAAAC	ACTAAACG
ACCTAACA	CCTAACAG
AAAGCCCG	AAAGCTCG
AAAGCCTC	AAAGCTCG
AAAGCCGA	AAAGCTCG
ATCTGAAA	TCTGAAAG
AAACGCAT	GAACGCAT
AAGCAACC	AAGCACCC
AAACGCTC	AAAGCTCG
AAAGCCGC	AAAGCTCG
AAAGCCGT	AAAGCTCG
AAAGCCGN	AAAGCTCG
ATTTTACA	AATTTTAC
ATTTTACC	AATTTTAC
ATTTTACT	AATTTTAC
AAAAATCA	TAAAAATC
AAAGCTAC	AAAGCTCG
AAAGCTCA	AAAGCTCG
AATNTATG	AATTATGT
AAAGCTCC	AAAGCTCG
AAAGCTCT	AAAGCTCG
AAGNCACC	AAGCACCC
AAAGCTCG	AAAGCTCG
AAAGCTCN	AAAGCTCG
AAAGCTTC	AAAGCTCG
AAAGCTTG	AAAGCTCG
AAAGCTGA	AAAGCTCG
AAAGCTGC	AAAGCTCG
AAAGCTGT	AAAGCTCG
AAAGCTGG	AAAGCTCG
AAAGCTGN	AAAGCTCG
AAAAATCC	TAAAAATC
AAAAATCT	TAAAAATC
AAAAATCG	TAAAAATC
AAAAATCN	TAAAAATC
AAAAATGC	AGAAATGC
AAAGCTNC	AAAGCTCG
ACTACAAC	ACTAAACG
AAAGCTNG	AAAGCTCG
ACTACAAT	ACACAATG
AAAGCGTC	AAAGCTCG
ATTTTACG	AATTTTAC
ATTTTACN	AATTTTAC
ACATCAAT	ACACAATG
AAACGTTT	AACGTTTA
AATTNATG	AATTATGT
ATNTCCTC	ATTCCTCC
AAAGCNCG	AAAGCTCG
AAAGCNTC	AAAGCTCG
ATTANAGG	ATTACAGG
ATCTGAGG	ACTGAGGA
ACCATATG	CCATATGC
AACGAAGG	ACGAAGGG
AANTTATG	AATTATGT
ACGAAACG	ACTAAACG
ACGAAATG	AGAAATGC
ACTACACG	ACTAAACG
ACTACATC	ACTCATCC
AAGCACAC	AAGCACCC
ACATCATC	ACTCATCC
ACTCNATC	ACTCATCC
AAAGTCTC	AAAGCTCG
AAAGTCGA	AAAGCTCG
AGAACATG	AGAAATGC
AAAGTCGC	AAAGCTCG
AAAGTCGG	AAAGCTCG
AAAGTCGN	AAAGCTCG
AAAGTTCG	AAAGCTCG
AAGCACCA	AAGCACCC
AAGCACCC	AAGCACCC
AAAGTTTA	AACGTTTA
AAGCACCT	AAGCACCC
AAGCACCG	AAGCACCC
ACNGAAGG	ACGAAGGG
AAGCACCN	AAGCACCC
AAGCACTC	AAGCACCC
ATCCACCT	GTCCACCT
ATGTCAGT	AGTCAGTT
ACGAAAGG	ACGAAGGG
ACTGTAGG	ACTGAGGA
ACTACAGG	ATTACAGG
ATTNACAG	ATTACAGG
AAAACTCG	AAAGCTCG
ACTACCAT	ACTTCCAT
ACTGTCCA	ACTTCCAT
ACTACCCG	ACTCCCGA
ACGAACGG	ACGAAGGG
ATTANCAG	ATTACAGG
AAAGTTGT	AATGTTGT
ACTCNCCG	ACTCCCGA
ACTCNCGA	ACTCCCGA
ACGCGTAT	AGCGTATC
ACTACCGA	ACTCCCGA
ACGAATGG	ACGAAGGG
ACTGTCGT	AATGTCGT
AACCTCAG	AACTCAGT
ACGAAGAG	ACGAAGGG
ACGAAGCG	ACGAAGGG
ACGAAGTG	ACGAAGGG
ACTCNTCC	ACTCATCC
ACCTATGG	ACCTTGGT
AACAATGA	ACACAATG
AACAATGC	ACACAATG
ACGAAGGA	ACGAAGGG
ACGAAGGC	ACGAAGGG
ACGAAGGT	ACGAAGGG
ACGAAGGG	ACGAAGGG
ACGAAGGN	ACGAAGGG
ACAGNCCG	ACAGCCGG
ACGAAGNG	ACGAAGGG
ACCATCCA	ACTCATCC
ACTACTCG	CTACTCGT
ACCATCCC	ACTCATCC
ACCATCCT	ACTCATCC
ACCATCCG	ACTCATCC
ACCATCCN	ACTCATCC
AATNTCGT	AATGTCGT
ACTGTTTA	CACTGTTT
ACTGTTTC	CACTGTTT
ACTGTTTT	CACTGTTT
ACTGTTTG	CACTGTTT
ACTGTTTN	CACTGTTT
ACTGTTGT	AATGTTGT
ACAAGCCG	ACAGCCGG
ACATCCAT	ACTTCCAT
AAGCACGC	AAGCACCC
ACATCCCG	ACTCCCGA
ACCTAGGA	CCTAGGAA
ACCTAGGT	ACCTTGGT
AACAATGT	ACACAATG
AACAATGG	ACACAATG
AACAATGN	ACACAATG
ACGGCCCA	CGGCCCAT
AAAGGCTC	AAAGCTCG
AACAAGAA	AATAAGAA
ACGAANGG	ACGAAGGG
ACGACAAT	ACACAATG
AATCCCGA	ACTCCCGA
ACTGTGCC	CTGTGCCA
ATGTCCTC	ATTCCTCC
ACTGTGGA	ACTGAGGA
ACAGNCGG	ACAGCCGG
ATGAGCGC	AGAGCGCG
AAAGGTCG	AAAGCTCG
ACCTCATC	ACTCATCC
ACCTCAGT	AACTCAGT
ACGACAGG	ACGAAGGG
ACTTAAAC	ACTAAACG
ACATCCGG	ACAGCCGG
AAAATGAC	TAAATGAC
AAGTGTCG	AATGTCGT
AAAATGCA	AGAAATGC
AAAATGCC	AGAAATGC
AAAATGCT	AGAAATGC
AAAATGCG	AGAAATGC
AAGTGTTG	AATGTTGT
AAAATGCN	AGAAATGC
ACAAGCTC	AAAGCTCG
AACACAAT	ACACAATG
AAAGGGGC	TAAGGGGC
ACTTAACG	ACTAAACG
AATNTTAC	AATTTTAC
ACGGCCGG	ACAGCCGG
AAGCACNC	AAGCACCC
ACNCTTGG	ACCTTGGT
ACCTCCAT	ACTTCCAT
ACTTACAT	ACTTCCAT
ACTTACAG	ATTACAGG
ACCTCCCG	ACTCCCGA
ACTTACCA	ACTTCCAT
AAATAAGA	AATAAGAA
ATTTTTAC	AATTTTAC
AACACAGT	AACTCAGT
ACTATAAC	ACTAAACG
ACTGGAAC	TCTGGAAC
AACACCCA	AAGCACCC
AACACCCC	AAGCACCC
AACACCCT	AAGCACCC
AACACCCG	AAGCACCC
ACTATACG	ACTAAACG
AACACCCN	AAGCACCC
ACTGGAGG	ACTGAGGA
AATTNTAC	AATTTTAC
ATACCTCC	ATTCCTCC
AACGATTA	AACGTTTA
ACTTATCC	ACTCATCC
AACGATTT	AACGTTTA
ACCTCTGG	ACCTTGGT
AANTTTAC	AATTTTAC
AACCTTTA	AACGTTTA
ACTTATGT	AATTATGT
AAAGNCTC	AAAGCTCG
AATNTTTA	AATTTTAC
AACNGTTT	AACGTTTA
AATCCTCC	ATTCCTCC
ACGACTTG	CCGACTTG
ACTATCCC	ACTCATCC
ACTATCCT	ACTCATCC
ACTATCCG	ACTCATCC
ACTATCCN	ACTCATCC
AAAAGAAC	AATAAGAA
AAAAGAAT	AATAAGAA
AAAAGAAG	AATAAGAA
AAAAGAAN	AATAAGAA
AATTNTTA	AATTTTAC
ACTGGCCA	CTGGCCAA
ACCTCGGT	ACCTTGGT
AAGCATCC	AAGCACCC
AAAGNTCG	AAAGCTCG
AACCTTGG	ACCTTGGT
AATNTTGT	AATGTTGT
ACTTAGGA	ACTGAGGA
AAATATGT	AATTATGT
ACGACGGG	ACGAAGGG
AAAAGATT	TAAAGATT
AATTNTGT	AATTATGT
AAAAGCTC	AAAGCTCG
ACCTTAGT	ACCTTGGT
ACCTTAGG	ACCTTGGT
ATCTGGAA	TCTGGAAC
ACCTTCCA	ACTTCCAT
ACTGGGAA	ACTGAGGA
ACTGGGAC	ACTGAGGA
AANTTTTA	AATTTTAC
ACTGGGAT	ACTGAGGA
ACTGGGAG	ACTGAGGA
ACTGGGAN	ACTGAGGA
ATTCAAAA	TTCAAAAG
ACGTAAAC	ACTAAACG
ACGATAGG	ACGAAGGG
ACTTCAAT	ACTTCCAT
ACTTCACA	ACTTCCAT
ACCTTCGT	ACCTTGGT
ACCTTCGG	ACCTTGGT
AACGCACC	AAGCACCC
AACGCATA	GAACGCAT
AACGCATC	GAACGCAT
AACGCATT	GAACGCAT
AACGCATG	GAACGCAT
AACGCATN	GAACGCAT
ACCTTTAC	GCCTTTAC
ATACTCAG	AACTCAGT
AACGCAGT	AACTCAGT
ACNAAACG	ACTAAACG
ACTGGGGA	ACTGAGGA
ATACTCGT	CTACTCGT
AGAACTGC	AGAAATGC
ATCCCATG	TCCCATGC
AAATCAGT	AACTCAGT
ACCATTGG	ACCTTGGT
ACGTAAGG	ACGAAGGG
ACCTTTGT	ACCTTGGT
ACCTTTGG	ACCTTGGT
AACATCAG	AACTCAGT
ACCTTGAT	ACCTTGGT
ACCTTGAG	ACCTTGGT
ACTTCATA	ACTTCCAT
ACTTCATT	ACTTCCAT
ACTTCATG	ACTTCCAT
ACTTCATN	ACTTCCAT
AAGCAGCC	AAGCACCC
ACTAGAAC	ACTAAACG
AACGCTCG	AAAGCTCG
ACTAGACG	ACTAAACG
AACGCTTA	AACGTTTA
AACGCTTT	AACGTTTA
ACTTCCAA	ACTTCCAT
ACTTCCAC	ACTTCCAT
ACTTCCAT	ACTTCCAT
ACTTCCAG	ACTTCCAT
ACTTCCAN	ACTTCCAT
ACTTCCCA	ACTTCCAT
ACTTCCCT	ACTTCCAT
ACTTCCCG	ACTCCCGA
ATCCCTCC	ATTCCTCC
ATTTGCCT	AGTTGCCT
ATAGAGCA	TAGAGCAG
ATTCACAG	ATTACAGG
ACCTTGCT	ACCTTGGT
ACCTTGCG	ACCTTGGT
ATGAGGAA	ACTGAGGA
ATGAGGAC	ACTGAGGA
ACCTTGTA	ACCTTGGT
ATGAGGAT	ACTGAGGA
ACCTTGTC	ACCTTGGT
ATGAGGAG	ACTGAGGA
ACCTTGTT	ACCTTGGT
ATGAGGAN	ACTGAGGA
ACCTTGTG	ACCTTGGT
ATTCACTC	ATTCCTCC
ACCTTGTN	ACCTTGGT
ACCTTGGA	ACCTTGGT
ACCTTGGC	ACCTTGGT
ACCTTGGT	ACCTTGGT
ACCTTGGG	ACCTTGGT
ATCCCGAA	ACTCCCGA
ACCTTGGN	ACCTTGGT
ATCCCGAC	ACTCCCGA
ATCCCGAT	ACTCCCGA
ATCCCGAG	ACTCCCGA
ACCTTGNT	ACCTTGGT
ATCCCGAN	ACTCCCGA
ACCTTGNG	ACCTTGGT
AACATTTA	AACGTTTA
ACTAGAGG	ACTGAGGA
ATNCCTCC	ATTCCTCC
ACTTCCTA	ACTTCCAT
ACAAGGGA	ACGAAGGG
ACAAGGGC	ACGAAGGG
ACTTCCTT	ACTTCCAT
ACAAGGGT	ACGAAGGG
ACTTCCTG	ACTTCCAT
ACAAGGGG	ACGAAGGG
ACTTCCTN	ACTTCCAT
ACAAGGGN	ACGAAGGG
ATGTCGTA	AATGTCGT
ATGTCGTC	AATGTCGT
ATGTCGTT	AATGTCGT
ACTTCCGT	ACTTCCAT
ATGTCGTG	AATGTCGT
AGAACGCA	GAACGCAT
ACTTCCNA	ACTTCCAT
AGAACGCG	AGAGCGCG
ACTTCCNT	ACTTCCAT
ACTAGCCG	ACAGCCGG
ACTGNAGG	ACTGAGGA
ACTTCTAT	ACTTCCAT
ACTTCTCA	ACTTCCAT
ATCCCGCG	AGCCCGCG
AAATCTCG	AAAGCTCG
ACGTATCA	AGCGTATC
ACGTATCC	AGCGTATC
ACGTATCT	AGCGTATC
ACGTATCG	AGCGTATC
ACGTATCN	AGCGTATC
ACNGAGGA	ACTGAGGA
ACNAAGGG	ACGAAGGG
ACGTAGAA	CGTAGAAA
ACCTTNGT	ACCTTGGT
ACCTTNGG	ACCTTGGT
ACGATGGG	ACGAAGGG
ATGTCGTN	AATGTCGT
AACGTATA	AACGTTTA
AACGTATC	AGCGTATC
AACGTATT	AACGTTTA
AACATGGA	TACATGGA
ACATCGGT	CATCGGTC
ACTTCGAT	ACTTCCAT
ACTTCGCA	ACTTCCAT
ATACGTTT	AACGTTTA
ACNACAAT	ACACAATG
ACGTAGGG	ACGAAGGG
ATAGCACC	AAGCACCC
ACCATGGT	ACCTTGGT
ACCTGAGG	ACTGAGGA
ACTTCNAT	ACTTCCAT
ACTTCNCA	ACTTCCAT
ACTAGGAC	ACTGAGGA
ACTAGGAT	ACTGAGGA
AAGCANCC	AAGCACCC
ACTAGGAG	ACTGAGGA
ACTAGGAN	ACTGAGGA
AATAAAAC	AATAAGAA
ATCCTCCA	ATTCCTCC
ATCCTCCC	ATTCCTCC
AACGTCAG	AACTCAGT
ATCCTCCT	ATTCCTCC
ATCCTCCG	ATTCCTCC
ATCCTCCN	ATTCCTCC
AACGTCTA	AACGTTTA
AACGTCTT	AACGTTTA
AACGTCGT	AATGTCGT
ATAGCCGG	ACAGCCGG
AACGTTAA	AACGTTTA
ACGTCATC	ACTCATCC
AACGTTAC	AACGTTTA
ACGTCAGT	AGTCAGTT
ATTTGGCT	CTTTGGCT
ATAGCTCG	AAAGCTCG
ACGTCCAT	ACTTCCAT
ATTCAGTT	AGTCAGTT
AAGGACCC	AAGCACCC
ATTCAGGA	ATTACAGG
ATTCAGGC	ATTACAGG
ATTCAGGT	ATTACAGG
ATTCAGGG	ATTACAGG
ATTCAGGN	ATTACAGG
ACATTATG	AATTATGT
AAATTATG	AATTATGT
ACGTCCCG	ACTCCCGA
ACGAGAGG	ACGAAGGG
ACGTCCGG	CGTCCGGG
ACGAGCCG	ACAGCCGG
ACGAGCGC	AGAGCGCG
AAATTTAC	AATTTTAC
AANCACCC	AAGCACCC
AATAAAAT	AATAAGAA
AATAAAAG	AATAAGAA
AATAAAAN	AATAAGAA
AATAAACG	ACTAAACG
ACTTTCAT	ACTTCCAT
ATAGCGCG	AGAGCGCG
ACTTTCCA	ACTTCCAT
AATAAAGA	AATAAGAA
ACTANAAC	ACTAAACG
ACANAATG	ACACAATG
AAATTTTA	AATTTTAC
ACTANACG	ACTAAACG
AATAACAA	AATAAGAA
AACGTTAT	AACGTTTA
AACGTTAG	AACGTTTA
AACGTTAN	AACGTTTA
AACGTTCA	AACGTTTA
AACGTTCT	AACGTTTA
AACGTTTA	AACGTTTA
AACGTTTC	AACGTTTA
AACGTTTT	AACGTTTA
AACAGCCG	ACAGCCGG
AACGTTTG	AACGTTTA
AACGTTTN	AACGTTTA
ACATTCCA	ACTTCCAT
AACGTTGA	AACGTTTA
AACAGCTC	AAAGCTCG
ATCCTTGG	ACCTTGGT
AATCTATG	AATTATGT
ACCTGTGG	ACCTTGGT
ACTGNGGA	ACTGAGGA
AACGTTNA	AACGTTTA
AATCTCAG	AACTCAGT
AGAATATG	AGAAATGC
ACTTTTAC	AATTTTAC
AACGTTNT	AACGTTTA
ACGAGGAA	ACTGAGGA
ACGAGGAC	ACTGAGGA
ACGAGGAT	ACTGAGGA
ACGAGGAG	ACTGAGGA
ACGAGGAN	ACTGAGGA
ACTTTTTA	GCTTTTTA
ATAGTAAC	TTAGTAAC
AAGCCACC	AAGCACCC
AACGTGTA	AACGTTTA
AACGTGTT	AACGTTTA
AATGAAGA	AATAAGAA
AAGCCCCA	AAGCACCC
AAGCCCCC	AAGCACCC
ACATTTTA	AATTTTAC
AAGCCCCT	AAGCACCC
AATAACGA	AATAAGAA
ACCTGGTA	ACCTTGGT
ACCTGGTC	ACCTTGGT
AATCTCGT	AATGTCGT
ACCTGGTT	ACCTTGGT
ACCTGGTG	ACCTTGGT
ACGAGGGA	ACGAAGGG
ACCTGGTN	ACCTTGGT
ACGAGGGC	ACGAAGGG
ACGAGGGT	ACGAAGGG
AAACAATG	ACACAATG
ACGAGGGG	ACGAAGGG
ACGAGGGN	ACGAAGGG
AAANCTCG	AAAGCTCG
AAATGACA	TAAATGAC
AAATGACC	TAAATGAC
AATCTTAC	AATTTTAC
AAATGACT	TAAATGAC
AAATGACG	TAAATGAC
ACCAGCCG	ACAGCCGG
AAATGACN	TAAATGAC
ATTNCAGG	ATTACAGG
AATCTTTA	AATTTTAC
AAACACCC	AAGCACCC
ACTTTGGC	CTTTGGCT
ACTTTGGT	ACCTTGGT
ATTNCCTC	ATTCCTCC
ATTCCACC	ATTCCTCC
AATGACGT	AATGTCGT
ATTCCATA	ACTTCCAT
AAGCCCCG	AAGCACCC
AAGCCCCN	AAGCACCC
AAGCCCGC	AGCCCGCG
AANTGTCG	AATGTCGT
AANTGTTG	AATGTTGT
ATTCCATT	ACTTCCAT
ATTCCATG	ACTTCCAT
AACAGTTT	AACGTTTA
AACGTNTA	AACGTTTA
AATCTTGT	AATGTTGT
ACCTGGGT	ACCTTGGT
ATTCCATN	ACTTCCAT
ACATTGGT	ACCTTGGT
AACGTNTT	AACGTTTA
ATTCCAGG	ATTACAGG
AACCGTTC	AGCCGTTC
ATTCCCCA	ATTCCTCC
AATAATAA	AATAAGAA
AATAATAT	GATAATAT
AAGGCACC	AAGCACCC
AATAATGA	AATAAGAA
AATAATGT	AATTATGT
AATNGTCG	AATGTCGT
AATNGTTG	AATGTTGT
AACCGTTT	AACGTTTA
ATTCCCCC	ATTCCTCC
ATTCCCCT	ATTCCTCC
AAGCCGTT	AGCCGTTC
ATTCCCCG	ATTCCTCC
ATTCCCCN	ATTCCTCC
ATTNCTCC	ATTCCTCC
AAGCCGGA	ACAGCCGG
ATTCCCTC	ATTCCTCC
AAGCCGGC	ACAGCCGG
AAGCCGGT	ACAGCCGG
AAGCCGGG	ACAGCCGG
ATTCCCGA	ACTCCCGA
AATGATCG	AATGTCGT
AATGATTG	AATGTTGT
ATTCCTAC	ATTCCTCC
AAATGCTC	AAAGCTCG
AATAAGAA	AATAAGAA
ATTCCTCA	ATTCCTCC
AATAAGAC	AATAAGAA
ATTCCTCC	ATTCCTCC
AATAAGAT	AATAAGAA
ACATGAGG	ACTGAGGA
AATAAGAG	AATAAGAA
ATTCCTCT	ATTCCTCC
ATGTTGCC	AGTTGCCT
AATAAGAN	AATAAGAA
ATTCCTCG	ATTCCTCC
AATAAGCA	AATAAGAA
ATTCCTCN	ATTCCTCC
ACNGCCGG	ACAGCCGG
ATTCCTTC	ATTCCTCC
ATGTTGTA	AATGTTGT
ATGTTGTC	AATGTTGT
ATGTTGTT	AATGTTGT
AATAAGTA	AATAAGAA
ACANCAAT	ACACAATG
ATGTTGTG	AATGTTGT
ATGTTGTN	AATGTTGT
ATTCCTGC	ATTCCTCC
ACTNAAAC	ACTAAACG
AAGCCGGN	ACAGCCGG
AAGGCCCG	CAGGCCCG
ACTNAACG	ACTAAACG
ACGANAGG	ACGAAGGG
AATAAGGA	AATAAGAA
AGAATTGC	AGAAATGC
AATAAGNA	AATAAGAA
AATAANAA	AATAAGAA
ATTCCTNC	ATTCCTCC
AGAATGCA	AGAAATGC
AATGAGAA	AATAAGAA
ATTCCGCC	ATTCCTCC
ATTCCGTC	ATTCCTCC
ACATGCCG	ACAGCCGG
AATGAGGA	ACTGAGGA
ACNTAAAC	ACTAAACG
AAATGTCG	AATGTCGT
ACTTGAGG	ACTGAGGA
AAATGTTG	AATGTTGT
ACANCCGG	ACAGCCGG
ACACAAAT	ACACAATG
ACTTGCAT	ACTTCCAT
ACACAAAG	ACACAATG
AAGGCTCG	AAAGCTCG
AGAATGCC	AGAAATGC
AGAATGCT	AGAAATGC
AGAATGCG	AGAAATGC
AGAATGCN	AGAAATGC
AATAANGA	AATAAGAA
ATATAAGA	AATAAGAA
ACTTGCCA	ACTTCCAT
ATATACAG	ATTACAGG
ACACAACT	ACACAATG
ACTTGCCT	AGTTGCCT
ACACAACG	ACACAATG
ACACAATA	ACACAATG
ACACAATC	ACACAATG
ACACAATT	ACACAATG
AAGCTACC	AAGCACCC
ACACAATG	ACACAATG
ACACAATN	ACACAATG
ACACAAGA	ACACAATG
ACACAAGC	ACACAATG
ATTCCNCC	ATTCCTCC
ACACAAGT	ACACAATG
ACACAAGG	ACACAATG
ACACAAGN	ACACAATG
ATTCCNTC	ATTCCTCC
ACACAANT	ACACAATG
ACACAANG	ACACAATG
AACGGTTA	AACGTTTA
ACATGTCG	AATGTCGT
AACGGTTT	AACGTTTA
ACACACAT	ACACAATG
ACATGTTG	AATGTTGT
AATACAGA	AATAAGAA
ATTCTACG	GTTCTACG
AATACAGG	ATTACAGG
ACGTTCCA	ACTTCCAT
ATGTGCCA	CTGTGCCA
AATCGTCG	AATGTCGT
AAGCTAGA	GAAGCTAG
AAGCTAGC	GAAGCTAG
AAGCTAGT	GAAGCTAG
AAGCTAGG	GAAGCTAG
AATCGTTT	AACGTTTA
AAGCTAGN	GAAGCTAG
AATCGTTG	AATGTTGT
ATAAAAAT	TAAAAATC
ATCAAAAG	TTCAAAAG
AATGCACC	AAGCACCC
ATAAAATA	TTAAAATA
ATCCGTTC	AGCCGTTC
ACGGGACC	TCGGGACC
ATTCTCCA	ATTCCTCC
ATTCTCCC	ATTCCTCC
ATTCTCCT	ATTCCTCC
ATTCTCCG	ATTCCTCC
ACTTGGTA	ACCTTGGT
ACATGGAA	TACATGGA
ATTCTCCN	ATTCCTCC
ACTTGGTC	ACCTTGGT
ACATGGAC	TACATGGA
ACTTGGTT	ACCTTGGT
ACATGGAT	TACATGGA
ATTCTCTC	ATTCCTCC
ACTTGGTG	ACCTTGGT
ACATGGAG	TACATGGA
ACTTGGTN	ACCTTGGT
ACATGGAN	TACATGGA
AAGCTCAG	AACTCAGT
AAGCTCCC	AAGCACCC
ACACACTG	ACACAATG
ATTCTTCC	ATTCCTCC
ACACATAT	ACACAATG
AATCGGTC	CATCGGTC
ACACATCC	ACTCATCC
ACGTTTAA	AACGTTTA
ACGTTTAC	AACGTTTA
ACGTTTAT	AACGTTTA
ACGTTTAG	AACGTTTA
ACCTNTGG	ACCTTGGT
ATCGAAGG	ACGAAGGG
ACGTTTAN	AACGTTTA
ACTCAAAC	ACTAAACG
ACACATTG	ACACAATG
ACTCAACC	ACTCATCC
ACTCAACG	ACTAAACG
AAGCTCGA	AAAGCTCG
AAGCTCGC	AAAGCTCG
ACTCAATC	ACTCATCC
AAGCTCGT	AAAGCTCG
AAGCTCGG	AAAGCTCG
ACTCAATG	ACACAATG
AAGCTCGN	AAAGCTCG
ACTNATCC	ACTCATCC
ACGANGGG	ACGAAGGG
ATAAACGA	ACTAAACG
ATAAACGC	ACTAAACG
ATAAACGT	ACTAAACG
ATAAACGG	ACTAAACG
ATAAACGN	ACTAAACG
ACACATGA	ACACAATG
ACACATGC	ACACAATG
ATTAAAAT	TTAAAATA
ACACATGT	ACACAATG
ACACATGG	ACACAATG
ACACATGN	ACACAATG
ATTAAACG	ACTAAACG
ACACAGAT	ACACAATG
AATGCCGT	AATGTCGT
AANCTCAG	AACTCAGT
ACACAGTG	ACACAATG
ACCTNGGT	ACCTTGGT
ACTNAGGA	ACTGAGGA
ATGTGGGC	TTGTGGGC
AAACCTAA	CAACCTAA
ATTAAAGG	ATTACAGG
ACGTTGCC	AGTTGCCT
AGAAGATG	AGAAATGC
AAACCTCG	AAAGCTCG
AATGCTTG	AATGTTGT
ATAAATGA	TAAATGAC
ATAAATGC	AGAAATGC
ACGGGTGA	GCGGGTGA
AATGCTGT	AATGTTGT
ACGTTGGT	ACCTTGGT
ACTCACCA	ACTCATCC
ACTCACCC	ACTCATCC
ACTCACCT	ACTCATCC
ACTCACCN	ACTCATCC
ACTCACTC	ACTCATCC
AATACGAA	AATAAGAA
ACTTNCAT	ACTTCCAT
ACNTCATC	ACTCATCC
ACTCACGA	ACTCCCGA
ACTTNCCA	ACTTCCAT
ATTAACAG	ATTACAGG
AATGCGTA	AATGTCGT
ACACANAT	ACACAATG
AATGCGTC	AATGTCGT
AATGCGTT	AATGTCGT
AATGCGTG	AATGTCGT
ACCNTTGG	ACCTTGGT
AATGCGTN	AATGTCGT
ACACANTG	ACACAATG
ATGCACCC	AAGCACCC
AGAAGCTA	GAAGCTAG
AGAAGCTC	AAAGCTCG
AGAAGCGC	AGAGCGCG
ATTGACAG	ATTACAGG
ACTCATAC	ACTCATCC
ACTCATCA	ACTCATCC
ATAAAGAT	TAAAGATT
ACACCAAT	ACACAATG
ACTCATCC	ACTCATCC
ACTCATCT	ACTCATCC
ACTCATCG	ACTCATCC
ACTCATCN	ACTCATCC
ACACCATG	ACACAATG
ACCCAATG	ACACAATG
ACNTCCAT	ACTTCCAT
ACNTCCCG	ACTCCCGA
AAGGTCGT	AATGTCGT
ACCNTGGT	ACCTTGGT
ATATCCTC	ATTCCTCC
ACGCAATG	ACACAATG
ACTCATTC	ACTCATCC
AACTAAAC	ACTAAACG
ACTCATGC	ACTCATCC
ACTCATNC	ACTCATCC
ACGTGAGG	ACTGAGGA
AACTAAGA	AATAAGAA
AACTAAGT	AACTCAGT
AATGTACG	AATGTCGT
ACTNCATC	ACTCATCC
AAGCGACC	AAGCACCC
AACTACAG	AACTCAGT
ACCGAAGG	ACGAAGGG
ACCCATCC	ACTCATCC
ACGCAAGG	ACGAAGGG
AAGGTTTA	AACGTTTA
AGAAGTGC	AGAAATGC
ACACCCGA	ACTCCCGA
AAGGTTGT	AATGTTGT
ACGCACCC	AAGCACCC
AACGNTTA	AACGTTTA
AACGNTTT	AACGTTTA
AAANGCTC	AAAGCTCG
AATATATG	AATTATGT
AATATAGA	AATAAGAA
AACCACCC	AAGCACCC
AAGAAATG	AGAAATGC
ATTAAGAA	AATAAGAA
ATTCGCTC	ATTCCTCC
AAGAACCC	AAGCACCC
ATTAAGGA	ATTACAGG
AGAAGGGA	ACGAAGGG
AGAAGGGC	ACGAAGGG
ACACCCGG	ACAGCCGG
AGAAGGGT	ACGAAGGG
ACTCAGCC	ACTCATCC
AATGTCAT	AATGTCGT
AGAAGGGG	ACGAAGGG
AATGTCAG	AATGTCGT
AGAAGGGN	ACGAAGGG
ACCCATGC	TCCCATGC
ACTCAGTA	AACTCAGT
AATGTCCT	AATGTCGT
AATGTCCG	AATGTCGT
ACTCAGTG	AACTCAGT
ATTGAGGA	ACTGAGGA
ACTCAGTN	AACTCAGT
AATGTCTA	AATGTCGT
ACTCAGGA	ACTGAGGA
AATGTCTC	AATGTCGT
AATGTCTT	AATGTCGT
ACTNCCAT	ACTTCCAT
AATGTCTN	AATGTCGT
AATGTCGA	AATGTCGT
AATGTCGC	AATGTCGT
AATGTCGT	AATGTCGT
AATGTCGG	AATGTCGT
AATGTCGN	AATGTCGT
AATGTCNT	AATGTCGT
ACCGACTT	CCGACTTG
AATGTCNG	AATGTCGT
ACNAGCCG	ACAGCCGG
ACGCACGA	CGCACGAC
AATGTTAC	AATTTTAC
AAAGACTC	AAAGCTCG
ACGCATCC	ACTCATCC
ACTNCCCG	ACTCCCGA
AACTATGT	AATTATGT
ACTNCCGA	ACTCCCGA
AATGTTAT	AATGTTGT
ACTCANCC	ACTCATCC
AATATCGT	AATGTCGT
AATGTTAG	AATGTTGT
AATGTTCT	AATGTTGT
ACTCANTC	ACTCATCC
AAGCGCCC	AAGCACCC
AATGTTTC	AATGTTGT
AAGCGCGA	AGAGCGCG
AAGCGCGC	AGAGCGCG
AAGCGCGT	AGAGCGCG
AAGCGCGG	AGAGCGCG
AAGCGCGN	AGAGCGCG
ATTAAGGC	ATTACAGG
ACTCCACG	ACTCCCGA
AATATTAC	AATTTTAC
AATGTTTT	AATGTTGT
ATTAAGGT	ATTACAGG
AATGTTTG	AATGTTGT
ATTAAGGG	ATTACAGG
ACTCCATA	ACTTCCAT
AATGTTTN	AATGTTGT
ATTAAGGN	ATTACAGG
AATGTTGA	AATGTTGT
ATTCGTCC	ATTCCTCC
AATGTTGC	AATGTTGT
ACTCCATT	ACTTCCAT
AATGTTGT	AATGTTGT
ACTCCATG	ACTTCCAT
AATGTTGG	AATGTTGT
ACTCCATN	ACTTCCAT
AATGTTGN	AATGTTGT
ACTCCAGA	ACTCCCGA
AATATTTA	AATTTTAC
AATGTTNT	AATGTTGT
AATGTTNG	AATGTTGT
ATAACAGG	ATTACAGG
AATATTGT	AATGTTGT
AATATTGG	GATATTGG
ACTCCCAA	ACTCCCGA
AATGTGCG	AATGTCGT
AATATGAA	AATAAGAA
AAGCGTAT	AGCGTATC
ATCACAAT	ACACAATG
AANAAGAA	AATAAGAA
ATGCCCGC	AGCCCGCG
AAGCGTTT	AACGTTTA
AAACTCAG	AACTCAGT
AACCAGTA	AACTCAGT
AACCAGTC	AACTCAGT
AACCAGTT	AACTCAGT
AACCAGTG	AACTCAGT
AACCAGTN	AACTCAGT
ATGCCTCC	ATTCCTCC
ACGCAGGG	ACGAAGGG
AAACTCGA	AAAGCTCG
AAACTCGC	AAAGCTCG
AACTAGTA	AACTCAGT
AACTAGTC	AACTCAGT
AACTAGTT	AACTCAGT
AATATGTA	AATTATGT
AACTAGTG	AACTCAGT
AAAGATCG	AAAGCTCG
AATATGTC	AATTATGT
AACTAGTN	AACTCAGT
AATATGTT	AATTATGT
AAAGATTA	TAAAGATT
AATATGTG	AATTATGT
AATATGTN	AATTATGT
AAAGATTC	TAAAGATT
AAAGATTT	TAAAGATT
ATTACAAG	ATTACAGG
AAAGATTG	TAAAGATT
AAAGATTN	TAAAGATT
ATCACAGG	ATTACAGG
ATTACACG	ATTACAGG
ACACCGGA	ACAGCCGG
AATGTNCG	AATGTCGT
ACACCGGC	ACAGCCGG
ACACCGGT	ACAGCCGG
ACACCGGG	ACAGCCGG
ATTACATG	ATTACAGG
ACACCGGN	ACAGCCGG
AATGTNTG	AATGTTGT
ACTGAAAC	ACTAAACG
ATTACAGA	ATTACAGG
ATATTATG	AATTATGT
ACTCCCAC	ACTCCCGA
ACTCCCAG	ACTCCCGA
ACTCCCAN	ACTCCCGA
AGAANATG	AGAAATGC
ATCTAAAC	ACTAAACG
ACTCCCCA	ACTCCCGA
AAGAAGAA	AATAAGAA
AATTAATG	AATTATGT
AATTAAGA	AATAAGAA
ACTCCCCG	ACTCCCGA
AATTAAGT	AATTATGT
ACTCCCTA	ACTCCCGA
AAACTCGT	AAAGCTCG
ATTACAGC	ATTACAGG
AAACTCGG	AAAGCTCG
ATTACAGT	ATTACAGG
ACTCCCTG	ACTCCCGA
AAACTCGN	AAAGCTCG
ATTACAGG	ATTACAGG
ATTACAGN	ATTACAGG
ACTCCCGA	ACTCCCGA
ACTCCCGC	ACTCCCGA
ACTCCCGT	ACTCCCGA
ACTCCCGG	ACTCCCGA
ATCGCTGG	TCGCTGGC
ATTACANG	ATTACAGG
ACTCCCGN	ACTCCCGA
ACTCCCNA	ACTCCCGA
AAGAAGGG	ACGAAGGG
ACTCCCNG	ACTCCCGA
ATTACCAG	ATTACAGG
AACTCAAT	AACTCAGT
AANGCACC	AAGCACCC
ATTACCCT	TTTACCCT
AACTCAAG	AACTCAGT
ATTACCTC	ATTCCTCC
AACTCACT	AACTCAGT
AACTCACG	AACTCAGT
AGCAAATG	AGAAATGC
AACTCATA	AACTCAGT
ATTGCAGG	ATTACAGG
AACTCATT	AACTCAGT
ATGCCGTT	AGCCGTTC
AACTCATG	AACTCAGT
ACTGAAAG	TCTGAAAG
AGAAAATG	AGAAATGC
AGAAAAGC	AGAAATGC
ACTGAACG	ACTAAACG
ACCGAGGA	ACTGAGGA
AATTACAG	ATTACAGG
ACNTTCCA	ACTTCCAT
ACTGAAGA	ACTGAGGA
ACAAAACG	ACTAAACG
ACAAAATG	ACACAATG
ATCTACAG	ATTACAGG
AATTACTG	AATTATGT
ACCCCCGA	ACTCCCGA
ACTCCTCG	ACTCCCGA
ACANGCCG	ACAGCCGG
AATTACGT	AATTATGT
ACAGAATG	ACACAATG
ACTCCTGA	ACTCCCGA
ACAGAAGG	ACGAAGGG
AACCCAGT	AACTCAGT
ACTCCGAA	ACTCCCGA
ACTCCGAC	ACTCCCGA
ACTCCGAT	ACTCCCGA
ATTGCCTA	AGTTGCCT
ACTCCGAG	ACTCCCGA
ACTCCGAN	ACTCCCGA
ATTGCCTT	AGTTGCCT
ATTGCCTG	AGTTGCCT
ACACTAAT	ACACAATG
ATTGCCTN	AGTTGCCT
AANCGTTT	AACGTTTA
AACTCATN	AACTCAGT
ATTACCGG	ATTACAGG
AACTCAGA	AACTCAGT
AACTCAGC	AACTCAGT
AACTCAGT	AACTCAGT
AACTCAGG	AACTCAGT
AACTCAGN	AACTCAGT
AACTCANT	AACTCAGT
AACTCANG	AACTCAGT
ATTACTAG	ATTACAGG
ATTACTCC	ATTCCTCC
AACTCCAG	AACTCAGT
AGAAACTG	AGAAATGC
AACTCCCG	ACTCCCGA
AGAANTGC	AGAAATGC
AAGACACC	AAGCACCC
AGAAACGC	AGAAATGC
AATTATAC	AATTTTAC
ATTACTGG	ATTACAGG
AATTATAT	AATTATGT
AATTATAG	AATTATGT
ATATTTTA	AATTTTAC
AATTATCT	AATTATGT
AATTATCG	AATTATGT
AATTATTC	AATTATGT
AATTATTT	AATTATGT
AAGGGGCA	TAAGGGGC
AATTATTG	AATTATGT
AAGGGGCC	TAAGGGGC
AATTATTN	AATTATGT
AAGGGGCT	TAAGGGGC
AATTATGA	AATTATGT
ACTGACGA	ACTGAGGA
AAGGGGCG	TAAGGGGC
AATTATGC	AATTATGT
AAGGGGCN	TAAGGGGC
AATTATGT	AATTATGT
AATTATGG	AATTATGT
ACTGACGG	ACTGAGGA
AATTATGN	AATTATGT
ACACTATG	ACACAATG
ACAAACGA	ACTAAACG
ACTCCGCG	ACTCCCGA
ACAGACCG	ACAGCCGG
ACAAACGC	ACTAAACG
AAGGGGGG	CAGGGGGG
ACAAACGT	ACTAAACG
ACAAACGG	ACTAAACG
ACAAACGN	ACTAAACG
ACTCCGGA	ACTCCCGA
AATAGAAA	AATAAGAA
AATAGAAC	AATAAGAA
ACTNTCCA	ACTTCCAT
AATAGAAT	AATAAGAA
AATAGAAG	AATAAGAA
AATAGAAN	AATAAGAA
ATTGCTCC	ATTCCTCC
ACGNAAGG	ACGAAGGG
AATAGAGA	AATAAGAA
AATGGCGT	AATGTCGT
AACCCTCA	GACCCTCA
AACTCCGT	AACTCAGT
AATTATNT	AATTATGT
AATTATNG	AATTATGT
AGAAATAC	AGAAATGC
AATTAGAA	AATAAGAA
AGAAATAG	AGAAATGC
AGCAACGG	GCAACGGC
AGAAATCA	AGAAATGC
ATTCNCTC	ATTCCTCC
AGAAATCC	AGAAATGC
AGAAATCT	AGAAATGC
AACTCTAG	AACTCAGT
AATGGTCG	AATGTCGT
AGAAATCG	AGAAATGC
AGAAATCN	AGAAATGC
AANGCTCG	AAAGCTCG
AATTAGTA	AATTATGT
AGAAATTC	AGAAATGC
AATTAGTC	AATTATGT
AGCAATAC	GCAATACT
AACTCTCG	CACTCTCG
AATTAGTT	AATTATGT
AATGGTTG	AATGTTGT
AGAAATTG	AGAAATGC
ACGCCCGA	ACTCCCGA
AATTAGTG	AATTATGT
AAGACCCA	AAGCACCC
ACGCCCGC	AGCCCGCG
ACAGACGG	ACAGCCGG
AATTAGTN	AATTATGT
AAGACCCC	AAGCACCC
AGAAATGA	AGAAATGC
AAGACCCT	AAGCACCC
AGAAATGC	AGAAATGC
AAGACCCG	AAGCACCC
AGAAATGT	AGAAATGC
AATTAGGT	AATTATGT
AAGACCCN	AAGCACCC
AGAAATGG	AGAAATGC
AGAAATGN	AGAAATGC
ACACTCAG	AACTCAGT
AGAAATNC	AGAAATGC
AACTCTGT	AACTCAGT
AGAAATNG	AGAAATGC
AAGCNACC	AAGCACCC
ACTGATCC	ACTCATCC
ACCCCGAA	ACTCCCGA
ACCCCGAC	ACTCCCGA
ACACTCTC	CACTCTCG
ACCCCGAT	ACTCCCGA
ACCCCGAG	ACTCCCGA
ATATTGGA	GATATTGG
ACCCCGAN	ACTCCCGA
ATATTGGC	GATATTGG
ATATTGGT	GATATTGG
ATTACGAG	ATTACAGG
ACTGATGA	ACTGAGGA
AGAGTATC	AGCGTATC
ACCCCGCG	AGCCCGCG
ACTGATGG	ACTGAGGA
ACAAATGA	ACACAATG
ACTCCNCG	ACTCCCGA
ACCCCGGC	CCCCGGCA
ACTGAGAA	ACTGAGGA
ACAAATGT	ACACAATG
ACTGAGAC	ACTGAGGA
ACAAATGG	ACACAATG
ATTACGGA	ATTACAGG
ACNTTGGT	ACCTTGGT
ACTGAGAT	ACTGAGGA
ACAAATGN	ACACAATG
ATTACGGC	ATTACAGG
ACTGAGAG	ACTGAGGA
ATTACGGT	ATTACAGG
ACTGAGAN	ACTGAGGA
ATTACGGG	ATTACAGG
ACTGAGCA	ACTGAGGA
ATTACGGN	ATTACAGG
ACTCCNGA	ACTCCCGA
AGCAATGC	AGAAATGC
AGAAAGCA	AGAAATGC
ATTACNAG	ATTACAGG
AGAAAGCC	AGAAATGC
AGAAAGCT	AGAAATGC
AGAAAGCG	AGAAATGC
AGAAAGCN	AGAAATGC
ATCGTATC	AGCGTATC
AAGCNCCC	AAGCACCC
AGAAAGTG	AGAAATGC
AGAAAGGC	AGAAATGC
ATATTGGG	GATATTGG
ATATTGGN	GATATTGG
ATTCNTCC	ATTCCTCC
AACTCGAG	AACTCAGT
AATAGCTC	AAAGCTCG
AATGGTGT	AATGTTGT
AACTCGTA	AACTCAGT
AACTCGTC	AACTCAGT
AACTCGTT	AACTCAGT
AACTCGTG	AACTCAGT
AACTCGTN	AACTCAGT
AACTCGGT	AACTCAGT
ACACTTGG	ACCTTGGT
ACTGAGCG	ACTGAGGA
AATTANTG	AATTATGT
ACTGAGTA	ACTGAGGA
ATGGATCA	TGGATCAA
AATTANGT	AATTATGT
ACTGAGTG	ACTGAGGA
ACTGAGGA	ACTGAGGA
CANTCTCG	CACTCTCG
ACTGAGGC	ACTGAGGA
ACTGAGGT	ACTGAGGA
ACTGAGGG	ACTGAGGA
ACTGAGGN	ACTGAGGA
ACAAAGTC	CCAAAGTC
ACTGAGNA	ACTGAGGA
AGAGTCGC	AGAGCGCG
ACTGAGNG	ACTGAGGA
ACCGCCGG	ACAGCCGG
ACAAAGGG	ACGAAGGG
ACACTGTT	CACTGTTT
AATAGTCG	AATGTCGT
AATAGTTG	AATGTTGT
AACCCGCG	AGCCCGCG
AATTCATG	AATTATGT
ATCGTTTA	AACGTTTA
AATTCAGT	AACTCAGT
AACTCNAG	AACTCAGT
AACTCNGT	AACTCAGT
ACGCCGTT	AGCCGTTC
ACGCCGGA	ACAGCCGG
ATTACNGG	ATTACAGG
ACGCCGGC	ACAGCCGG
ACGNAGGG	ACGAAGGG
ACGCCGGT	ACAGCCGG
ACTGANGA	ACTGAGGA
ACGCCGGG	ACAGCCGG
ACGCCGGN	ACAGCCGG
ACTNGAGG	ACTGAGGA
ACTGANGG	ACTGAGGA
ACNTGAGG	ACTGAGGA
ACAGAGCT	CAGAGCTT
AGAAANTG	AGAAATGC
ATAATATA	GATAATAT
ATAATATC	GATAATAT
ATAATATT	GATAATAT
AGAAANGC	AGAAATGC
ATAATATG	GATAATAT
ACAACAAT	ACACAATG
ATAATATN	GATAATAT
ACAGAGGA	ACTGAGGA
AATAGGAA	AATAAGAA
ATCATCCA	ACTCATCC
ATCATCCC	ACTCATCC
ATCATCCT	ACTCATCC
ATCATCCG	ACTCATCC
ATCATCCN	ACTCATCC
ACTCTATC	ACTCATCC
AATTCCAT	ACTTCCAT
AATTCCTC	ATTCCTCC
ACACGAAT	ACACAATG
ACACGATG	ACACAATG
ACCCTCAA	GACCCTCA
ACCCTCAC	GACCCTCA
ACCCTCAT	GACCCTCA
ACCCTCAG	GACCCTCA
AGCACAAT	ACACAATG
AACTTATG	AATTATGT
ACCCTCAN	GACCCTCA
CCAATACT	GCAATACT
AACTTAGT	AACTCAGT
AATGNCGT	AATGTCGT
CCAATATG	CCATATGC
CCAATAGT	CCAAAGTC
AACTTCAG	AACTCAGT
CANTCGGT	CATCGGTC
AACTTCCA	ACTTCCAT
ACACGCCG	ACAGCCGG
ATTATAGG	ATTACAGG
ACTGCATC	ACTCATCC
AATTCTAC	AATTTTAC
AGAGTGCG	AGAGCGCG
AGCCGATC	AGCCGTTC
AGCCGATT	AGCCGTTC
ACAGCAAT	ACACAATG
ACTGCAGG	ACTGAGGA
ACAGCACC	AAGCACCC
ATTGTCGT	AATGTCGT
ACAGCACG	ACAGCCGG
AATTCTTA	AATTTTAC
ATTATCAG	ATTACAGG
AGCACCCA	AAGCACCC
AGCACCCC	AAGCACCC
ACTCTCCC	ACTCATCC
AATGNTCG	AATGTCGT
AGCACCCT	AAGCACCC
ACTCTCCT	ACTCATCC
ACAGCAGG	ACAGCCGG
AGCACCCG	AAGCACCC
AGCACCCN	AAGCACCC
ACTCTCCN	ACTCATCC
AGCCGCTC	AGCCGTTC
AATTCTGT	AATTATGT
AGCCGCTT	AGCCGTTC
ACTGCCAT	ACTTCCAT
AGCCGCGA	AGCCCGCG
AATGNTTG	AATGTTGT
AGCCGCGC	AGCCCGCG
AATANAGA	AATAAGAA
AGCCGCGT	AGCCCGCG
ACAGCCAG	ACAGCCGG
AGCCGCGG	AGCCCGCG
AGCCGCGN	AGCCCGCG
ACAGCCCG	ACAGCCGG
AATGNTGT	AATGTTGT
AGCACCGC	AGCCCGCG
ACTGCCCG	ACTCCCGA
ACTCTCGC	CACTCTCG
ACTCTCGT	CACTCTCG
ACAGCCTG	ACAGCCGG
ACTCTCGG	CACTCTCG
ACAGCCGA	ACAGCCGG
ACAGCCGC	ACAGCCGG
ACTCTCGN	CACTCTCG
ACAGCCGT	ACAGCCGG
ACAGCCGG	ACAGCCGG
ACAGCCGN	ACAGCCGG
ACAGCCNG	ACAGCCGG
ATCTCATC	ACTCATCC
ACTGCCGA	ACTCCCGA
ATGGCCAA	CTGGCCAA
ACAACCTA	CAACCTAA
ACTGCCGG	ACAGCCGG
ATTGTTGT	AATGTTGT
AANGTCGT	AATGTCGT
ATCTCAGT	AACTCAGT
AGACATGC	AGAAATGC
AGCCGTAC	AGCCGTTC
ACTCTTCC	ACTCATCC
ACAGCTGG	ACAGCCGG
AGCCGTCA	AGCCGTTC
AGCCGTCC	AGCCGTTC
AGCCGTCT	AGCCGTTC
ATGAAATG	AGAAATGC
AGCCGTCG	AGCCGTTC
ACCGTATC	AGCGTATC
AGCCGTCN	AGCCGTTC
AGCCGTTA	AGCCGTTC
ATATGTCG	AATGTCGT
AGCCGTTC	AGCCGTTC
AACNCAGT	AACTCAGT
AGCCGTTT	AGCCGTTC
AGCCGTTG	AGCCGTTC
ACAGCGGA	ACAGCCGG
ACAGCGGC	ACAGCCGG
AGCCGTTN	AGCCGTTC
ACAGCGGT	ACAGCCGG
ACCCTTGG	ACCTTGGT
ACAGCGGG	ACAGCCGG
ATCTCCCG	ACTCCCGA
AANGTTTA	AACGTTTA
ATATGTTG	AATGTTGT
ACAGCGGN	ACAGCCGG
AGCCGTGC	AGCCGTTC
ACACGTTT	AACGTTTA
AGCCGTGT	AGCCGTTC
ATCTCCTC	ATTCCTCC
AACTTTAA	AACGTTTA
AACTTTAT	AACGTTTA
AGACAGTT	AGTCAGTT
AACTTTAG	AACGTTTA
AGCCGTNC	AGCCGTTC
AGCACGAC	CGCACGAC
AANGTTGT	AATGTTGT
AACTTTAN	AACGTTTA
AGCCGTNT	AGCCGTTC
ATTGTGGG	TTGTGGGC
ACAGCNCG	ACAGCCGG
AATTCGTA	AATGTCGT
AGCACGCG	AGCCCGCG
AATTCGTC	AATGTCGT
AATTCGTT	AATGTCGT
AATTCGTG	AATGTCGT
AATTCGTN	AATGTCGT
ATTATGTA	AATTATGT
AGCACGTT	AGCCGTTC
ATTATGTC	AATTATGT
AANTAAGA	AATAAGAA
ATTATGTT	AATTATGT
ACGGAAGG	ACGAAGGG
ATTATGTG	AATTATGT
ATTATGTN	AATTATGT
ACAGCNGG	ACAGCCGG
ACAACCGG	ACAGCCGG
AATANGAA	AATAAGAA
AGAGGCGA	AGAGCGCG
AGAGGCGC	AGAGCGCG
ACTCTTGG	ACCTTGGT
AGAGGCGT	AGAGCGCG
AGAGGCGG	AGAGCGCG
ACAGTACT	CAGTACTC
AGAGGCGN	AGAGCGCG
ATTTACAG	ATTACAGG
ACGGACTT	TCGGACTT
ATTTACCC	TTTACCCT
ATGCGATC	GTGCGATC
ATGGCTTC	GTGGCTTC
AGCCGGCG	AGCCCGCG
ATCGGACT	TCGGACTT
AGCCGGTC	AGCCGTTC
AGCCGGTT	AGCCGTTC
ACCCTGGT	ACCTTGGT
ACAGTCCG	ACAGCCGG
AGCATATC	AGCGTATC
AANTATGT	AATTATGT
AGCATAGA	GGCATAGA
ACAGTCGG	ACAGCCGG
ACCGTTCA	AGCCGTTC
ACCGTTCC	AGCCGTTC
AAGTAAGA	AATAAGAA
ACCGTTCT	AGCCGTTC
AATNAAGA	AATAAGAA
ACCGTTCG	AGCCGTTC
ACCGTTCN	AGCCGTTC
AACTTGGT	ACCTTGGT
ACCGTTTA	AACGTTTA
AGACCCTC	GACCCTCA
AGACCCTT	TGACCCTT
CCAATGCA	CCATATGC
AGCCGNTC	AGCCGTTC
CCAATGCC	CCATATGC
CCAATGCT	CCATATGC
AGACCCGC	AGCCCGCG
CCAATGCG	CCATATGC
CCAATGCN	CCATATGC
AATCAAGA	AATAAGAA
CCAATGTC	CCAAAGTC
AGATAACC	TGATAACC
AAGTACCC	AAGCACCC
AAGTACTC	CAGTACTC
ACTGCGGA	ACTGAGGA
AATCACCC	AAGCACCC
ACNCAATG	ACACAATG
ACAACGGC	GCAACGGC
AGAGGGCG	AGAGCGCG
AGCCGNTT	AGCCGTTC
ACTAAAAC	ACTAAACG
ACTAAAAG	ACTAAACG
ACCGTTGG	ACCTTGGT
ACTAAACA	ACTAAACG
ACTAAACC	ACTAAACG
ACTAAACT	ACTAAACG
AATCATCC	ACTCATCC
ACTAAACG	ACTAAACG
ACTAAACN	ACTAAACG
ACTAAATC	ACTAAACG
ATTTATGT	AATTATGT
AGATAATA	GATAATAT
AGACCGTT	AGCCGTTC
ACTAAATG	ACTAAACG
ACTAAAGA	ACTAAACG
AGATAATG	AGAAATGC
ACGCTTGG	ACCTTGGT
ACTAAAGC	ACTAAACG
ACTAAAGT	ACTAAACG
AATCATGT	AATTATGT
AGATAAGA	AATAAGAA
AANTCAGT	AACTCAGT
ATCGGTCA	CATCGGTC
ATCGGTCC	CATCGGTC
ATCGGTCT	CATCGGTC
ATCGGTCG	CATCGGTC
ATCGGTCN	CATCGGTC
AATCAGAA	AATAAGAA
ACCGTGGT	ACCTTGGT
AATCAGTA	AACTCAGT
AATCAGTC	AACTCAGT
ACACNAAT	ACACAATG
AATCAGTG	AACTCAGT
AATCAGTN	AACTCAGT
AAGNACCC	AAGCACCC
AACTGAGT	AACTCAGT
AACTGAGG	ACTGAGGA
AATNATGT	AATTATGT
ATAAGAAA	AATAAGAA
AATTTAAC	AATTTTAC
ATAAGAAC	AATAAGAA
ATAAGAAT	AATAAGAA
ATAAGAAG	AATAAGAA
AATNAGAA	AATAAGAA
ATAAGAAN	AATAAGAA
AATTTACA	AATTTTAC
AATTTACC	AATTTTAC
AATTTACT	AATTTTAC
ACTCGATC	ACTCATCC
AATTTACG	AATTTTAC
AATTTACN	AATTTTAC
AATTTATA	AATTTTAC
AATTTATG	AATTATGT
ACTCGAGG	ACTGAGGA
ACAATACT	GCAATACT
ACAGGCCC	CAGGCCCG
ACAGGCCG	ACAGCCGG
AAGTATGT	AATTATGT
ACTAAAGG	ACTAAACG
ACTAAAGN	ACTAAACG
ACGCTGGC	TCGCTGGC
AAGAGCAG	TAGAGCAG
ACTAAANC	ACTAAACG
ACTAAANG	ACTAAACG
ACTCGCCG	ACTCCCGA
ATGGTGAG	TGGTGAGG
ACAGGCGG	ACAGCCGG
ATCGGGAC	TCGGGACC
AGACTCAG	AACTCAGT
ACACNATG	ACACAATG
ACTAACAC	ACTAAACG
AAGAGCTC	AAAGCTCG
AAGAGCTT	CAGAGCTT
AACTGCAG	AACTCAGT
ACNCATCC	ACTCATCC
AAGAGCGC	AGAGCGCG
AACTGTCG	AATGTCGT
AACTGTTG	AATGTTGT
ACGGAGGA	ACTGAGGA
ACTAACAG	CCTAACAG
ACGGAGGG	ACGAAGGG
ATGCGTAT	AGCGTATC
AGATATTG	GATATTGG
ACTAACCG	ACTAAACG
ATTAGAGG	ATTACAGG
ACTAACGA	ACTAAACG
ACTAACGC	ACTAAACG
ACTAACGT	ACTAAACG
ATGAAGGG	ACGAAGGG
ACTAACGG	ACTAAACG
ACTAACGN	ACTAAACG
ATTAGCAG	ATTACAGG
CAAGAGCT	CAGAGCTT
ACCCGCGA	AGCCCGCG
ACCCGCGC	AGCCCGCG
ACTAATAC	ACTAAACG
ACCCGCGT	AGCCCGCG
ACCCGCGG	AGCCCGCG
AAGTCACC	AAGCACCC
ACCCGCGN	AGCCCGCG
AGTCTAGT	AGTCAGTT
AGCCNCGC	AGCCCGCG
ACTAATCC	ACTCATCC
AGAGNCGC	AGAGCGCG
ACCAAACG	ACTAAACG
ACTAATCG	ACTAAACG
ATCAGCCG	ACAGCCGG
AATTTCAC	AATTTTAC
ACCAAAGT	CCAAAGTC
ACCCGTTC	AGCCGTTC
AATTTCTA	AATTTTAC
CCAAGAGT	CCAAAGTC
AGCCNTTC	AGCCGTTC
AATTTCGT	AATGTCGT
AANAGCTC	AAAGCTCG
AATTTTAA	AATTTTAC
ATCAGTTA	AGTCAGTT
AATTTTAC	AATTTTAC
ATCAGTTC	AGTCAGTT
AATTTTAT	AATTTTAC
ATCAGTTT	AGTCAGTT
AATTTTAG	AATTTTAC
ATCAGTTG	AGTCAGTT
ATCAGTTN	AGTCAGTT
AACNTCAG	AACTCAGT
ATAAGCTC	AAAGCTCG
AGATATGC	AGAAATGC
AATTTTAN	AATTTTAC
AATTTTCA	AATTTTAC
AATTTTCC	AATTTTAC
ACTAAGAA	AATAAGAA
AATTTTCT	AATTTTAC
ACTAAGAC	ACTAAACG
AATTTTCG	AATTTTAC
AATTTTCN	AATTTTAC
AATTTTTA	AATTTTAC
AATTTTTC	AATTTTAC
ACTAAGCG	ACTAAACG
AATTTTGA	AATTTTAC
AATTTTGC	AATTTTAC
ATTAGTAA	TTAGTAAC
AGCCNGCG	AGCCCGCG
AATTTTNA	AATTTTAC
AATTTTNC	AATTTTAC
ACCCGGCA	CCCCGGCA
ACTAAGGA	ACTGAGGA
AGCCNGTT	AGCCGTTC
ACTCGCGA	ACTCCCGA
ACTAAGGG	ACGAAGGG
AATTTGAC	AATTTTAC
ACNCCCGA	ACTCCCGA
ATTTCAGG	ATTACAGG
ACTCGTCC	ACTCATCC
AGTCTTTG	GTCTTTGG
AGCAGCCG	ACAGCCGG
CCAAGTCA	CCAAAGTC
CCAAGTCC	CCAAAGTC
CCAAGTCT	CCAAAGTC
CCAAGTCG	CCAAAGTC
CCAAGTCN	CCAAAGTC
AGCAGCGC	AGAGCGCG
AACNTTTA	AACGTTTA
AGTCTGCC	AGTTGCCT
ACCAATGA	ACACAATG
ACCAATGC	ACACAATG
ATGACAGG	ATTACAGG
ACCAATGT	ACACAATG
AGTCTGTT	AGTCAGTT
AGAGNGCG	AGAGCGCG
ACTAANAC	ACTAAACG
ACAGGGGG	CAGGGGGG
ACTAANCG	ACTAAACG
ATGACCCT	TGACCCTT
CAAGCACC	AAGCACCC
ATCTTCCA	ACTTCCAT
AGCAGTAT	AGCGTATC
ATTTCCAT	ACTTCCAT
CCAAGGAA	CCTAGGAA
ACCAATGG	ACACAATG
ACCAATGN	ACACAATG
AATTTNAC	AATTTTAC
AGCAGTTA	AGTCAGTT
AGCAGTTT	AGTCAGTT
AGCAGTTG	AGTCAGTT
ATTTCCTC	ATTCCTCC
AGCAGTTN	AGTCAGTT
AATTTNTA	AATTTTAC
CCAAGGTC	CCAAAGTC
AACTNAGT	AACTCAGT
ACCAAGGG	ACGAAGGG
AAGTCGTA	AATGTCGT
AAGTCGTC	AATGTCGT
AAGTCGTT	AATGTCGT
AAGTCGTG	AATGTCGT
AAGTCGTN	AATGTCGT
ATAAGGGG	TAAGGGGC
AACTNCAG	AACTCAGT
AGCTAAAC	ACTAAACG
ACATAAAC	ACTAAACG
ATTTCTCC	ATTCCTCC
AATTGATG	AATTATGT
ACATAATG	ACACAATG
ACATAAGA	AATAAGAA
ACCACAAT	ACACAATG
ANTTACAG	ATTACAGG
CAAGCCCG	CAGGCCCG
CANTGTTT	CACTGTTT
CAAGCCTA	CAACCTAA
AGNTGCCT	AGTTGCCT
AGANAATG	AGAAATGC
AAGTTATG	AATTATGT
AGTCGAGT	AGTCAGTT
AATTGCCT	AGTTGCCT
CCAANAGT	CCAAAGTC
ATCTTTGG	GTCTTTGG
AATTGTAC	AATTTTAC
AGCTATCA	AGCGTATC
AGCTATCC	AGCGTATC
AATTGTCG	AATGTCGT
AGCTATCT	AGCGTATC
AGATCAGT	AGTCAGTT
AATTGTTA	AATTTTAC
AGACGCGA	AGAGCGCG
AGACGCGC	AGAGCGCG
AGACGCGT	AGAGCGCG
AATTGTTG	AATGTTGT
AGACGCGG	AGAGCGCG
AGACGCGN	AGAGCGCG
AATTGTGT	AATTATGT
AGCGCATC	AGCGTATC
AGACGTAT	AGCGTATC
CAAGCTAA	CAACCTAA
ANTTATGT	AATTATGT
CAAGCTAG	GAAGCTAG
AGACGTTC	AGCCGTTC
AGACGTTT	AACGTTTA
ANGAGCGC	AGAGCGCG
AGTCGCCT	AGTTGCCT
CAAGCTCG	AAAGCTCG
AAGTTTAA	AACGTTTA
CAAGCTTA	CAGAGCTT
CAAGCTTC	CAGAGCTT
AAGTTTAT	AACGTTTA
AAGTTTAG	AACGTTTA
CAAGCTTT	CAGAGCTT
AAGTTTAN	AACGTTTA
CAAGCTTG	CAGAGCTT
CAAGCTTN	CAGAGCTT
AGCTATCG	AGCGTATC
AGCTATCN	AGCGTATC
AGCGCCGC	AGCCCGCG
ATGATAAC	TGATAACC
AGTCGTAT	AGCGTATC
CAGNACTC	CAGTACTC
AGCGCTAT	AGCGTATC
AGGCCCAT	CGGCCCAT
ATCTTGGT	ACCTTGGT
AGCTAGTT	GGCTAGTT
AGGCCCGA	CAGGCCCG
AGGCCCGT	CAGGCCCG
AGGCCCGG	CAGGCCCG
AGGCCCGN	CAGGCCCG
AGANATGC	AGAAATGC
AAGTTTTA	AATTTTAC
AGCGCGTT	AGCCGTTC
ACATATGC	CCATATGC
AAGTTGCC	AGTTGCCT
AAGTTGTA	AATGTTGT
ATNACAGG	ATTACAGG
AAGTTGTC	AATGTTGT
AAGTTGTT	AATGTTGT
AAGTTGTG	AATGTTGT
AAGTTGTN	AATGTTGT
CCAANGTC	CCAAAGTC
AGTCGTTA	AGTCAGTT
AGGCCGCG	AGCCCGCG
CCATAACA	CCTAACAG
AGTCGTTT	AGTCAGTT
AGTCGTTG	AGTCAGTT
AGTCGTTN	AGTCAGTT
AGGCCGTT	AGCCGTTC
AGTNGCCT	AGTTGCCT
CCATAATG	CCATATGC
CCATAAGC	CCATATGC
CAGNAGCT	CAGAGCTT
CCATAAGT	CCAAAGTC
AGNCAGTT	AGTCAGTT
AGCGTAAC	AGCGTATC
AGCGTAAT	AGCGTATC
AGTCGGTT	AGTCAGTT
AGCTCATC	ACTCATCC
CATCAGTC	CATCGGTC
AGATCGCG	AGAGCGCG
CATCAGGT	CATCGGTC
AGCGTACA	AGCGTATC
AGCTCCCG	ACTCCCGA
AGCGTACC	AGCGTATC
AGCGTACT	AGCGTATC
AGCGTACG	AGCGTATC
CACAAAGT	CCAAAGTC
CACTNCTC	CACTCTCG
AGCGTACN	AGCGTATC
AGCGTATA	AGCGTATC
AGCGTATC	AGCGTATC
AGCGTATT	AGCGTATC
AGCGTATG	AGCGTATC
AGCGTATN	AGCGTATC
AGCGTAGC	AGCGTATC
AGCGTAGT	AGCGTATC
CAAGTACT	CAGTACTC
ANTTCCAT	ACTTCCAT
AGCGTANC	AGCGTATC
CCATACTG	CCATATGC
AGCGTANT	AGCGTATC
ANCTCATC	ACTCATCC
CCATACGC	CCATATGC
AGCGTCAT	AGCGTATC
ANCTCAGT	AACTCAGT
CACCCTAA	CAACCTAA
CCATATAC	CCATATGC
CACCCTCA	GACCCTCA
CCATATAG	CCATATGC
CACCCTCG	CACTCTCG
ANATTATG	AATTATGT
CCATATCA	CCATATGC
CCATATCC	CCATATGC
CCATATCT	CCATATGC
CCATATCG	CCATATGC
CCATATCN	CCATATGC
CCATATTC	CCATATGC
CCATATTG	CCATATGC
AGCTCCGC	AGCCCGCG
CCACAATG	ACACAATG
ATGTACAG	ATTACAGG
CACTNTCG	CACTCTCG
CATNCGGT	CATCGGTC
CACTNTTT	CACTGTTT
AGGCTAGT	GGCTAGTT
ANTTCCTC	ATTCCTCC
AGTAAACG	ACTAAACG
CATCCTAA	CAACCTAA
AGTAAATG	AGAAATGC
ANCTCCCG	ACTCCCGA
ANACAATG	ACACAATG
AGCGTCTC	AGCGTATC
CCATATGA	CCATATGC
ATACAATG	ACACAATG
CCATATGC	CCATATGC
CCATATGT	CCATATGC
CCATATGG	CCATATGC
CCATATGN	CCATATGC
CCATATNC	CCATATGC
AGCCACGC	AGCCCGCG
CCATATNG	CCATATGC
CACTNGTT	CACTGTTT
AGCGTTAT	AGCGTATC
CCATAGCA	CCATATGC
CCATAGCC	CCATATGC
CCATAGCT	CCATATGC
CCATAGCG	CCATATGC
CCATAGCN	CCATATGC
CCATAGTC	CCAAAGTC
CACCCGGC	CCCCGGCA
CCATAGTG	CCATATGC
CCATAGGA	CCTAGGAA
CCACAAGT	CCAAAGTC
CCATAGGC	CCATATGC
CATCCGTC	CATCGGTC
AGTCNAGT	AGTCAGTT
CATCCGGT	CATCGGTC
ANGTCAGT	AGTCAGTT
CATCCGGG	CGTCCGGG
AGCTCGCG	AGCCCGCG
ANCAGCCG	ACAGCCGG
AGCTCGTT	AGCCGTTC
CAGNCCCG	CAGGCCCG
CATTGTTT	CACTGTTT
AGCGTTTA	AACGTTTA
AGCGTTTC	AGCGTATC
AGCCATTC	AGCCGTTC
AGCGTGAT	AGCGTATC
AGATTATG	AATTATGT
ANATTTTA	AATTTTAC
AGCCAGCG	AGCCCGCG
CACAATGA	ACACAATG
CACAATGC	ACACAATG
CACAATGT	ACACAATG
CACAATGG	ACACAATG
CACAATGN	ACACAATG
CACCTAAA	CAACCTAA
CACCTAAC	CAACCTAA
CACCTAAT	CAACCTAA
CACCTAAG	CAACCTAA
CACCTAAN	CAACCTAA
CAGANCTT	CAGAGCTT
CCACATGC	CCATATGC
AGNCCCGC	AGCCCGCG
AGTGAGTT	AGTCAGTT
CCATANTG	CCATATGC
AGTGAGGA	ACTGAGGA
CCATANGC	CCATATGC
AGTAATGC	AGAAATGC
CANAGCTT	CAGAGCTT
AGCTTATC	AGCGTATC
CACCTCTC	CACTCTCG
CACCTCGA	CACTCTCG
CACCTCGC	CACTCTCG
CACCTCGT	CACTCTCG
CACCTCGG	CACTCTCG
CACCTCGN	CACTCTCG
ATACATGG	TACATGGA
CATTGGCT	CTTTGGCT
CATTGGTC	CATCGGTC
AGCGTGTC	AGCGTATC
AGTAAGAA	AATAAGAA
CCACAGTC	CCAAAGTC
AGTAAGTT	AGTCAGTT
CACGAAGG	ACGAAGGG
CATCTCTC	CACTCTCG
CACNTCTC	CACTCTCG
CCATCATG	CCATATGC
CATCTCGA	CACTCTCG
CATCTCGC	CACTCTCG
AGCTTCCA	ACTTCCAT
CAGANGCT	CAGAGCTT
CATCTCGT	CACTCTCG
CATCTCGG	CACTCTCG
CATCTCGN	CACTCTCG
AGANCGCG	AGAGCGCG
CACGACTT	CCGACTTG
CACCTTGG	ACCTTGGT
AGCCCACG	AGCCCGCG
ATACAGGA	ATTACAGG
ATACAGGC	ATTACAGG
ATACAGGT	ATTACAGG
ATACAGGG	ATTACAGG
ATACAGGN	ATTACAGG
AGATTTTA	AATTTTAC
AGCCCAGC	AGCCCGCG
AGGGATAC	GGGATACA
CAGTTACT	CAGTACTC
AGGGATCC	GGGGATCC
AGCCCCCG	AGCCCGCG
AGCGTNAT	AGCGTATC
AGNCCGCG	AGCCCGCG
AGTGCAGT	AGTCAGTT
AGNCCGTT	AGCCGTTC
AGTCNGTT	AGTCAGTT
AGCGTNTC	AGCGTATC
AGTGCCTA	AGTTGCCT
CACCTGTT	CACTGTTT
CACACAAT	ACACAATG
AGTGCCTC	AGTTGCCT
AGCTTTTT	GCTTTTTA
AGTGCCTT	AGTTGCCT
AGTGCCTG	AGTTGCCT
AGTGCCTN	AGTTGCCT
AGATTGCC	AGTTGCCT
AGCCCCGA	AGCCCGCG
AGCCCCGC	AGCCCGCG
AGCTTGCC	AGTTGCCT
AGCCCCGT	AGCCCGCG
AGCCCCGG	AGCCCGCG
CAACTAAA	CAACCTAA
AGCCCCGN	AGCCCGCG
CAACTAAC	CAACCTAA
CAACTAAT	CAACCTAA
CAACTAAG	CAACCTAA
CAACTAAN	CAACCTAA
CAGNTACT	CAGTACTC
AGGCGAGA	GGCGAGAC
CACGAGCT	CAGAGCTT
CAGTTCTC	CAGTACTC
CAAGGCCC	CAGGCCCG
ANTTTTAC	AATTTTAC
AGCCCTCG	AGCCCGCG
AGCCCTTC	AGCCGTTC
CATCTGTC	CATCGGTC
CATCTGTT	CACTGTTT
CATCTGGT	CATCGGTC
CAACTCAG	AACTCAGT
CACACCTA	CAACCTAA
AGCGGATC	AGCGTATC
AGCTTGGT	ACCTTGGT
CAACTCTA	CAACCTAA
CAACTCTC	CACTCTCG
CAACTCGT	CTACTCGT
AGGAAATG	AGAAATGC
AGTGCGAT	GTGCGATC
ANCTTCCA	ACTTCCAT
AGTGCGCG	AGAGCGCG
AGTACAGT	AGTCAGTT
AGTACAGG	ATTACAGG
CACNTGTT	CACTGTTT
CCATCTGC	CCATATGC
ANGCACCC	AAGCACCC
AGGCGCGA	AGAGCGCG
AGGCGCGC	AGAGCGCG
CAGCACCC	AAGCACCC
AGGCGCGT	AGAGCGCG
AGGCGCGG	AGAGCGCG
AGGCGCGN	AGAGCGCG
CAGTTGCC	AGTTGCCT
CAGCACTC	CAGTACTC
CCACCTAA	CAACCTAA
CAGCACGA	CGCACGAC
CAACTTAA	CAACCTAA
AGGCGTAT	AGCGTATC
CACACTCG	CACTCTCG
AGTTACAG	ATTACAGG
AGTTACCT	AGTTGCCT
AGCCCTGC	AGCCCGCG
CATCGATC	CATCGGTC
AGCCCGAC	AGCCCGCG
AGCCCGAG	AGCCCGCG
CATCGAGT	CATCGGTC
AGCCCGCA	AGCCCGCG
AGCCCGCC	AGCCCGCG
AGCCCGCT	AGCCCGCG
AGCCCGCG	AGCCCGCG
AGCCCGCN	AGCCCGCG
AGCCCGTC	AGCCCGCG
AGCTGAGG	ACTGAGGA
AGCCCGTT	AGCCGTTC
AGCCCGTG	AGCCCGCG
CCATCGGT	CATCGGTC
AGTACTCA	CAGTACTC
AGTACTCC	CAGTACTC
AGTACTCT	CAGTACTC
AGTACTCG	CAGTACTC
AGGCGTTC	AGCCGTTC
AGTACTCN	CAGTACTC
CACACGAC	CGCACGAC
CAAGGGGC	TAAGGGGC
AGCGGTAT	AGCGTATC
CAAGGGGG	CAGGGGGG
AGNAAATG	AGAAATGC
AGATGCCT	AGTTGCCT
ANATGTCG	AATGTCGT
CAAAAATC	TAAAAATC
ANGTTGCC	AGTTGCCT
CAACTGTT	CACTGTTT
CCACCGGC	CCCCGGCA
AGTTATGT	AATTATGT
AGGAATGC	AGAAATGC
CATCGCTC	CATCGGTC
AGCTGCCT	AGTTGCCT
CANGAGCT	CAGAGCTT
CATCGCGT	CATCGGTC
AGCCCGGA	AGCCCGCG
AGCCCGGC	AGCCCGCG
AGCCCGGT	AGCCCGCG
AGTTAGCC	AGTTGCCT
AGCCCGGG	AGCCCGCG
AGCCCGGN	AGCCCGCG
CACGCCCG	CAGGCCCG
AGTGTATC	AGCGTATC
AGCCCGNC	AGCCCGCG
AGCCCGNG	AGCCCGCG
AGTTAGTT	AGTCAGTT
CATCGTCA	CATCGGTC
CATCGTCC	CATCGGTC
CATCGTCT	CATCGGTC
AGCTGTAT	AGCGTATC
CATCGTCG	CATCGGTC
AGATGCGC	AGAGCGCG
CATCGTCN	CATCGGTC
CATCGTTC	CATCGGTC
AGCCCNCG	AGCCCGCG
ANTTGCCT	AGTTGCCT
ANATGTTG	AATGTTGT
AGCTGTTC	AGCCGTTC
AGCGGTTC	AGCCGTTC
CAGTGACT	CAGTACTC
AGCCCNGC	AGCCCGCG
CACCGTTT	CACTGTTT
CCATTATG	CCATATGC
CACGCTCG	CACTCTCG
AGATGTCG	AATGTCGT
ANCTTGGT	ACCTTGGT
CAGCAGCT	CAGAGCTT
AGATGTTG	AATGTTGT
ANTCATCC	ACTCATCC
CACCGGCA	CCCCGGCA
CACCGGTC	CATCGGTC
AGGAAGGG	ACGAAGGG
CATCGTGT	CATCGGTC
CATCGGAC	CATCGGTC
CATCGGAT	CATCGGTC
CCACTATG	CCATATGC
CATCGGCA	CATCGGTC
AGCGGGTG	GCGGGTGA
CATCGGCC	CATCGGTC
CATCGGCT	CATCGGTC
CATCGGCG	CATCGGTC
CATCGGCN	CATCGGTC
CATCGGTA	CATCGGTC
CATCGGTC	CATCGGTC
CATCGGTT	CATCGGTC
CATCGGTG	CATCGGTC
AGTGTCGT	AATGTCGT
CATCGGTN	CATCGGTC
AGCCTATC	AGCGTATC
CATCGGGC	CATCGGTC
ANACTCAG	AACTCAGT
CATCGGGT	CATCGGTC
CATCGGNC	CATCGGTC
AGNAATGC	AGAAATGC
CACNGTTT	CACTGTTT
AGTATAAC	GGTATAAC
AGGGCGCG	AGAGCGCG
ANTCAGTT	AGTCAGTT
CACATATG	CCATATGC
AGCGNATC	AGCGTATC
CAACGCAT	GAACGCAT
CAGTGCCA	CTGTGCCA
CAGTGCCC	CAGGCCCG
CATCGGNT	CATCGGTC
CAGTGCTC	CAGTACTC
CAGTGCTT	CAGAGCTT
CCACTCTC	CACTCTCG
CAACGCTA	CAACCTAA
AGTTCAGT	AGTCAGTT
CCACTCGT	CTACTCGT
CATCGNTC	CATCGGTC
AGTTCCAT	ACTTCCAT
CAACGTAA	CAACCTAA
CATCGNGT	CATCGGTC
CANGCCCG	CAGGCCCG
AGCCTCGC	AGCCCGCG
AGTTCCCT	AGTTGCCT
CCATTTGC	CCATATGC
AGTGTTGT	AATGTTGT
AGCGNTAT	AGCGTATC
AGCCTTCA	AGCCGTTC
ANCTGAGG	ACTGAGGA
AGCCTTCC	AGCCGTTC
AGCCTTCT	AGCCGTTC
AGCCTTCG	AGCCGTTC
AGCCTTCN	AGCCGTTC
AGCCTTTA	GCCTTTAC
AGCCTTTC	AGCCGTTC
AGTTCCTA	AGTTGCCT
CAAAAGTC	CCAAAGTC
AGTTCCTT	AGTTGCCT
AGTTCCTG	AGTTGCCT
AGTTCCTN	AGTTGCCT
AGCCTTGG	ACCTTGGT
ANGCCCGC	AGCCCGCG
CAGCCCAT	CGGCCCAT
AGGGTATC	AGCGTATC
CAGCCCCG	CAGGCCCG
AGNGCGCG	AGAGCGCG
CAACGTTT	AACGTTTA
ANGAAATG	AGAAATGC
CCACTTGA	CCGACTTG
CCACTTGC	CCGACTTG
CACATCTC	CACTCTCG
CCACTTGT	CCGACTTG
CAGCCCGA	CAGGCCCG
CCACTTGG	CCGACTTG
CCACTTGN	CCGACTTG
CAGCCCGT	CAGGCCCG
CAGCCCGG	CAGGCCCG
CAGCCCGN	CAGGCCCG
CAGCCTAA	CAACCTAA
CAGTGTTT	CACTGTTT
CAACGGCA	GCAACGGC
CANCCTAA	CAACCTAA
CAACGGCC	GCAACGGC
CAGNGCCC	CAGGCCCG
CAACGGCT	GCAACGGC
AGTTCTAC	GTTCTACG
CAACGGCG	GCAACGGC
CAACGGCN	GCAACGGC
CACGTACT	CAGTACTC
CCACTGTT	CACTGTTT
CAACGGTC	CATCGGTC
AGNCGTAT	AGCGTATC
AGCCTGCG	AGCCCGCG
CCATTGCA	CCATATGC
CCATTGCC	CCATATGC
AGANGCGC	AGAGCGCG
CCATTGCT	CCATATGC
AGTTCTGA	GGTTCTGA
CCATTGCG	CCATATGC
AGCCTGTT	AGCCGTTC
CCATTGCN	CCATATGC
AGNCGTTC	AGCCGTTC
AGGGTCTG	GGGTCTGC
CATGAGCT	CAGAGCTT
ANGCCGTT	AGCCGTTC
AGGGTCGT	GGGTCGTA
AGNGTATC	AGCGTATC
AGTTCGCC	AGTTGCCT
CAGNGCTT	CAGAGCTT
ANTCCCGA	ACTCCCGA
AGTGTGCC	AGTTGCCT
CCAAAATC	CCAAAGTC
CCAAAAGT	CCAAAGTC
CAGCCGTT	AGCCGTTC
CAGCCGGA	ACAGCCGG
CCAAACAG	CCTAACAG
CACGTCTC	CACTCTCG
CAAACCTA	CAACCTAA
CCAAACTC	CCAAAGTC
ANTCCTCC	ATTCCTCC
CACATGTT	CACTGTTT
CAGTGGGG	CAGGGGGG
AGTATGCC	AGTTGCCT
CCACGACA	CGCACGAC
CCACGACC	CGCACGAC
CAAACTAA	CAACCTAA
CCACGACT	CGCACGAC
CCACGACG	CGCACGAC
CCACGACN	CGCACGAC
CACGTTTC	CACTGTTT
CACGTTTT	CACTGTTT
CATNGGTC	CATCGGTC
CACGTTTG	CACTGTTT
CACGTTTN	CACTGTTT
CAGCCGGC	ACAGCCGG
CAGCCGGT	ACAGCCGG
CAGCCGGG	ACAGCCGG
CAGCCGGN	ACAGCCGG
ANGAAGGG	ACGAAGGG
CCAAACGT	CCAAAGTC
CAGNGGGG	CAGGGGGG
CCAAATCA	CCAAAGTC
CCAAATCC	CCAAAGTC
CCAAATCT	CCAAAGTC
CCAAATCG	CCAAAGTC
CCAAATCN	CCAAAGTC
CACATGGA	TACATGGA
CATCNGTC	CATCGGTC
CCAAATTC	CCAAAGTC
CCAAATGC	CCATATGC
CATCNGGT	CATCGGTC
CCAAATGT	CCAAAGTC
CACGTGTT	CACTGTTT
CACTAAAC	ACTAAACG
CACTAACA	CCTAACAG
CATGCCCG	CAGGCCCG
CAGCTACT	CAGTACTC
CANGTACT	CAGTACTC
CCATGATG	CCATATGC
CAACNCTA	CAACCTAA
CCAAAGAC	CCAAAGTC
CCAAAGAT	CCAAAGTC
CCAAAGCA	CCAAAGTC
CCAAAGCC	CCAAAGTC
CCAAAGCT	CCAAAGTC
CCAAAGCG	CCAAAGTC
CTGATAAC	TGATAACC
AGTAGAAA	CGTAGAAA
ANACGTTT	AACGTTTA
AGGGGATC	GGGGATCC
CCACGGCA	CCCCGGCA
AGTTTCCT	AGTTGCCT
AGGATACA	GGGATACA
CAACNTAA	CAACCTAA
CAGCTCTC	CACTCTCG
CAGTNACT	CAGTACTC
AGTGGCCT	AGTTGCCT
CCAAAGCN	CCAAAGTC
CCAAAGTA	CCAAAGTC
CCAAAGTC	CCAAAGTC
CCAAAGTT	CCAAAGTC
CCAAAGTG	CCAAAGTC
AGTGGCTT	GTGGCTTC
CCAAAGTN	CCAAAGTC
AGTTTTAC	AATTTTAC
CCAAAGGC	CCAAAGTC
CCAAAGGT	CCAAAGTC
CCAAAGNC	CCAAAGTC
CCAAAGNT	CCAAAGTC
CANCTCTC	CACTCTCG
CAGTNCTC	CAGTACTC
AGGATCAA	TGGATCAA
AGCGAATC	AGCGTATC
CAAATGAC	TAAATGAC
AGCGAAGG	ACGAAGGG
AGTAGCCT	AGTTGCCT
CCATGTGC	CCATATGC
AGTGGGAA	GGTGGGAA
CATTACAG	ATTACAGG
CCAAANTC	CCAAAGTC
CCCCNGCA	CCCCGGCA
CATGCGGT	CATCGGTC
CCAAANGT	CCAAAGTC
CCCCNGGC	CCCCGGCA
CACAGCCG	ACAGCCGG
AGTAGCGC	AGAGCGCG
CACAGCTT	CAGAGCTT
ANTAAACG	ACTAAACG
CATTACTC	CAGTACTC
AGTAGTTA	AGTCAGTT
CACTATCG	CACTCTCG
AGTAGTTC	AGTCAGTT
AGTAGTTT	AGTCAGTT
CACGGCCC	CAGGCCCG
AGTAGTTG	AGTCAGTT
CAGCTGTT	CACTGTTT
CACTATTT	CACTGTTT
AGTTTGCC	AGTTGCCT
CCAACAGA	CCTAACAG
AGCGATAT	AGCGTATC
CCAACAGC	CCTAACAG
ANAAATGC	AGAAATGC
CTGATGCC	CTGTGCCA
CCAACAGG	CCTAACAG
AGCGATCA	AGCGTATC
CCAACAGN	CCTAACAG
AGCGATCC	AGCGTATC
CATAACAG	CCTAACAG
AGCGATCT	AGCGTATC
AGCGATCG	AGCGTATC
AGCGATCN	AGCGTATC
AGGTATAA	GGTATAAC
AGGTATCA	AGCGTATC
AGGTATCC	AGCGTATC
AGGGGGGA	CAGGGGGG
AGGGGGGC	CAGGGGGG
AGCGAGAC	GGCGAGAC
AGGGGGGT	CAGGGGGG
CAGAAATG	AGAAATGC
AGGGGGGN	CAGGGGGG
CATAATAT	GATAATAT
CANCTGTT	CACTGTTT
AGTAGTTN	AGTCAGTT
CACAGTTT	CACTGTTT
CAATAAGA	AATAAGAA
AGCNCCGC	AGCCCGCG
CAAAGATT	TAAAGATT
CAGAACTC	CAGTACTC
CAGAACTT	CAGAGCTT
ANTAAGAA	AATAAGAA
CATAAGAA	AATAAGAA
AGAGAATG	AGAAATGC
CCAACCTA	CAACCTAA
CAATACTA	GCAATACT
AGGTATCT	AGCGTATC
CAATACTT	GCAATACT
AGGTATCG	AGCGTATC
CAATACTG	GCAATACT
AGGTATCN	AGCGTATC
CAATACTN	GCAATACT
CATGTACT	CAGTACTC
CAGCGCCC	CAGGCCCG
CAAAGCTC	AAAGCTCG
CAAAGCTT	CAGAGCTT
CACGGTCA	CATCGGTC
CACGGTCC	CATCGGTC
CAGCGCTT	CAGAGCTT
CACGGTCT	CATCGGTC
CACGGTCG	CATCGGTC
CACTAGTT	CACTGTTT
CACGGTCN	CATCGGTC
CACTAGGA	CCTAGGAA
CACGGTTT	CACTGTTT
CCAACTTG	CCGACTTG
AGCNCGCG	AGCCCGCG
CAATATGC	CCATATGC
AGCNCGTT	AGCCGTTC
CAGCGTAT	AGCGTATC
CTGAGACT	TGAGACTA
CCATNATG	CCATATGC
AGTTGACC	AGTTGCCT
CAGGACCC	CAGGCCCG
AGTTGACT	AGTTGCCT
CATTATGT	AATTATGT
CAGGACCG	CAGGCCCG
ANTGAGGA	ACTGAGGA
CAGGACTC	CAGTACTC
CCCTAACA	CCTAACAG
AGTTGCAC	AGTTGCCT
AGTTGCAT	AGTTGCCT
AGTTGCCA	AGTTGCCT
AGTTGCCC	AGTTGCCT
AGTTGCCT	AGTTGCCT
ANTACAGG	ATTACAGG
CTGAGCTT	CAGAGCTT
CAGCGGTC	CATCGGTC
CAAAGTCA	CCAAAGTC
CAAAGTCC	CCAAAGTC
CAAAGTCT	CCAAAGTC
CAAAGTCG	CCAAAGTC
CAAAGTCN	CCAAAGTC
CAGCGGGG	CAGGGGGG
AGAGACTA	TGAGACTA
AGTTGCCG	AGTTGCCT
AGTTGCCN	AGTTGCCT
CATGTCGT	AATGTCGT
AGCNTATC	AGCGTATC
AGTTGCTA	AGTTGCCT
AGTTGCTC	AGTTGCCT
AGTTGCTT	AGTTGCCT
AGAGACGC	AGAGCGCG
AGTTGCTG	AGTTGCCT
CATACCTA	CAACCTAA
CCAACGTC	CCAAAGTC
AGTTGCTN	AGTTGCCT
AGTTGCGC	AGTTGCCT
AGTTGCGT	AGTTGCCT
CAGGAGCT	CAGAGCTT
CCAACGGC	GCAACGGC
AGTTGCNC	AGTTGCCT
AGTTGCNT	AGTTGCCT
CATGTTTA	CACTGTTT
ANCCCGCG	AGCCCGCG
CATGTTTC	CACTGTTT
CAGGAGGG	CAGGGGGG
CANGGCCC	CAGGCCCG
CATGTTTT	CACTGTTT
CATGTTTG	CACTGTTT
AGTTGTCC	AGTTGCCT
CATGTTTN	CACTGTTT
AGTTGTCT	AGTTGCCT
CAANCCTA	CAACCTAA
CATACTCA	CAGTACTC
CTGAGGAA	ACTGAGGA
CATACTCC	CAGTACTC
CTGAGGAC	ACTGAGGA
CATACTCT	CAGTACTC
CACGGGGG	CAGGGGGG
CTGAGGAT	ACTGAGGA
CTGAGGAG	ACTGAGGA
CATACTCN	CAGTACTC
CTGAGGAN	ACTGAGGA
CAGAAGCT	CAGAGCTT
CAANCTAA	CAACCTAA
CAATCCTA	CAACCTAA
CAGGCACC	CAGGCCCG
CATGTTGT	AATGTTGT
CAGGCACG	CAGGCCCG
CATACGGT	CATCGGTC
CAATCTAA	CAACCTAA
ANGCGTAT	AGCGTATC
CAATCTCG	CACTCTCG
AGGTCAGT	AGTCAGTT
CATGTGCC	CTGTGCCA
CAGGCCAA	CTGGCCAA
CAGGCCAC	CAGGCCCG
AGAGATGC	AGAAATGC
ANCGAAGG	ACGAAGGG
CAGGCCAG	CAGGCCCG
CAGGCCCC	CAGGCCCG
CAGGCCCT	CAGGCCCG
CTTAGAAA	CGTAGAAA
CCCGGCAA	CCCCGGCA
CCCGGCAC	CCCCGGCA
CACTCACG	CACTCTCG
CCCGGCAT	CCCCGGCA
CCCGGCAG	CCCCGGCA
CCCGGCAN	CCCCGGCA
AGTTGGCC	AGTTGCCT
AGTTGGCT	AGTTGCCT
CACTCAGT	AACTCAGT
CAATCGGT	CATCGGTC
ANCACAAT	ACACAATG
CCCACTTG	CCGACTTG
AGGAGCGC	AGAGCGCG
AGNAGCGC	AGAGCGCG
CAGGCCCG	CAGGCCCG
CAGGCCCN	CAGGCCCG
CAGGCCTC	CAGGCCCG
CAGGCCTG	CAGGCCCG
CAGGCCGA	CAGGCCCG
CAGGCCGC	CAGGCCCG
CAGGCCGT	CAGGCCCG
CCATNTGC	CCATATGC
CAGGCCGG	CAGGCCCG
CAGGCCGN	CAGGCCCG
CCCTATGC	CCATATGC
CAGGCCNC	CAGGCCCG
CAGGCCNG	CAGGCCCG
CAGGCTCC	CAGGCCCG
CCCGGGCA	CCCCGGCA
CAGGCTCG	CAGGCCCG
ANAGCACC	AAGCACCC
CAGGCTTA	CAGAGCTT
CAGGCTTC	CAGAGCTT
CAGGCTTT	CAGAGCTT
CAGGCTTG	CAGAGCTT
CAGGCTTN	CAGAGCTT
AGGTCTGC	GGGTCTGC
CCCACGAC	CGCACGAC
AGNTCAGT	AGTCAGTT
AGTTGNCC	AGTTGCCT
AGTTGNCT	AGTTGCCT
CANCGGTC	CATCGGTC
CATTCCTC	ATTCCTCC
CACTCCTC	CACTCTCG
CCCACGGC	CCCCGGCA
CTTAGTAA	TTAGTAAC
CACTCCGA	CACTCTCG
CAGACCCG	CAGGCCCG
CACTCCGC	CACTCTCG
CACTCCGT	CACTCTCG
CAGACCTA	CAACCTAA
CACTCCGG	CACTCTCG
CACTCCGN	CACTCTCG
CAGACCTT	CAGAGCTT
AGAGAGCG	AGAGCGCG
ANATAAGA	AATAAGAA
CAATTATG	AATTATGT
CATTCTCG	CACTCTCG
AGCNGTAT	AGCGTATC
CAGACTCA	CAGTACTC
CAGACTCC	CAGTACTC
CAGGCGCC	CAGGCCCG
CAGGCGCG	CAGGCCCG
AGGTCGTA	GGGTCGTA
CANGGGGG	CAGGGGGG
CCCTAGGA	CCTAGGAA
CAGGCGGG	CAGGGGGG
CATATTGG	GATATTGG
CATATGCA	CCATATGC
CATATGCC	CCATATGC
CATATGCT	CCATATGC
CAGTAACT	CAGTACTC
CATATGCG	CCATATGC
CTTAGGAA	CCTAGGAA
CATATGCN	CCATATGC
CAGACTCT	CAGTACTC
CAGTAATC	CAGTACTC
CAGACTCG	CAGTACTC
CAGACTCN	CAGTACTC
CAGACTTA	CAGAGCTT
CAGACTTC	CAGAGCTT
CTTAGGCT	CTTTGGCT
CAGACTTT	CAGAGCTT
AGCNGTTC	AGCCGTTC
CAGACTTN	CAGAGCTT
CAGTACAC	CAGTACTC
CAGTACAT	CAGTACTC
CATGGCCA	CTGGCCAA
CAGTACCA	CAGTACTC
CCCATATG	CCATATGC
CATGGCCC	CAGGCCCG
CAGTACCC	CAGTACTC
CACTCTAC	CACTCTCG
CAGTACCT	CAGTACTC
CAGTACCG	CAGTACTC
CACTCTAG	CACTCTCG
CAGTACCN	CAGTACTC
CAGGCNCC	CAGGCCCG
CAGTACTA	CAGTACTC
CACTCTCA	CACTCTCG
CAGACGCT	CAGAGCTT
CACTCTCC	CACTCTCG
CAGGCNCG	CAGGCCCG
CACTCTCT	CACTCTCG
CATTCGGT	CATCGGTC
CACTCTCG	CACTCTCG
CACTCTCN	CACTCTCG
ANCCTTGG	ACCTTGGT
CACTCTTC	CACTCTCG
CACTCTTT	CACTGTTT
CACTCTTG	CACTCTCG
CACTCTGA	CACTCTCG
CACTCTGC	CACTCTCG
CACTCTGT	CACTCTCG
CTGTACCA	CTGTGCCA
ANAGCCGG	ACAGCCGG
CACTCTGG	CACTCTCG
CACTCTGN	CACTCTCG
CACTCTNC	CACTCTCG
CCAGAAGT	CCAAAGTC
CAATTTTA	AATTTTAC
CAGGTACT	CAGTACTC
AGTNAGTT	AGTCAGTT
ANAGCTCG	AAAGCTCG
CAGTACTC	CAGTACTC
CAGTACTT	CAGTACTC
CAGTACTG	CAGTACTC
CCAGACTT	CCGACTTG
CAGTACTN	CAGTACTC
CAGTACGC	CAGTACTC
CAGTACGT	CAGTACTC
AGTTNCCT	AGTTGCCT
CAGTACNC	CAGTACTC
CAGTACNT	CAGTACTC
CTGTACTC	CAGTACTC
CATAGAAA	CGTAGAAA
CATGGTCA	CATCGGTC
CAGTATCA	CAGTACTC
CATGGTCC	CATCGGTC
CAGTATCC	CAGTACTC
CATGGTCT	CATCGGTC
CAGTATCT	CAGTACTC
CATGGTCG	CATCGGTC
CAGTATCG	CAGTACTC
CATGGTCN	CATCGGTC
CAGTATCN	CAGTACTC
CAGTATTC	CAGTACTC
CCCATGCA	TCCCATGC
CCCATGCC	TCCCATGC
CCCATGCT	TCCCATGC
AGTCAATT	AGTCAGTT
CCCATGCG	TCCCATGC
CCCATGCN	TCCCATGC
AGTCAAGT	AGTCAGTT
CACTCTNG	CACTCTCG
CACTCGCG	CACTCTCG
AGNTTGCC	AGTTGCCT
CACTCGTA	CTACTCGT
CAGGTCCC	CAGGCCCG
CACTCGTG	CTACTCGT
CATGGGTC	CATCGGTC
AGAGCACC	AAGCACCC
CACTCGTN	CTACTCGT
ANAGCGCG	AGAGCGCG
CAGGTCCG	CAGGCCCG
AGAGCACG	AGAGCGCG
CACTCGGT	CATCGGTC
AGGTTCTG	GGTTCTGA
CCAGATGC	CCATATGC
CCTAAAAG	CCTAACAG
AGTCACTT	AGTCAGTT
CCTAAACA	CCTAACAG
CATGGGGG	CAGGGGGG
CCTAAACG	ACTAAACG
CAGATACT	CAGTACTC
CTGTAGAA	CGTAGAAA
AGTCACGT	AGTCAGTT
CCAGAGCT	CAGAGCTT
CCTAAAGA	CCTAACAG
CTGTAGCC	CTGTGCCA
CCTAAAGC	CCTAACAG
ANTGTCGT	AATGTCGT
CCAGAGTC	CCAAAGTC
CCTAAAGG	CCTAACAG
CCTAAAGN	CCTAACAG
CGCCTTTA	GCCTTTAC
CACTCNCG	CACTCTCG
CCTAACAA	CCTAACAG
CCTAACAC	CCTAACAG
CACTCNTC	CACTCTCG
CCTAACAT	CCTAACAG
CCTAACAG	CCTAACAG
AGTNCAGT	AGTCAGTT
CCTAACAN	CCTAACAG
AGAGCAGA	TAGAGCAG
CCTAACCA	CCTAACAG
ANTGTTGT	AATGTTGT
AGAGCAGT	TAGAGCAG
AGAGCAGG	TAGAGCAG
CCTAACCG	CCTAACAG
AGAGCAGN	TAGAGCAG
CATAGCTT	CAGAGCTT
CCTAACTA	CCTAACAG
AGTCATCC	ACTCATCC
CAGTAGAA	CGTAGAAA
AGTTNGCC	AGTTGCCT
AGTCATTA	AGTCAGTT
AGTCATTC	AGTCAGTT
AGTCATTT	AGTCAGTT
AGTCATTG	AGTCAGTT
AGTCATTN	AGTCAGTT
ANCCGTTC	AGCCGTTC
AGAGCCCG	AGAGCGCG
AGTCATGT	AGTCAGTT
CAGTAGTC	CAGTACTC
CANACCTA	CAACCTAA
CCTAACTG	CCTAACAG
CCTAACGA	CCTAACAG
AGAGCCGA	AGAGCGCG
CCTAACGC	CCTAACAG
AGAGCCGC	AGAGCGCG
CCTAACGT	CCTAACAG
AGAGCCGT	AGAGCGCG
CCTAACGG	CCTAACAG
AGTCAGAT	AGTCAGTT
CCTAACGN	CCTAACAG
CCTAACNA	CCTAACAG
CTGCACGA	CGCACGAC
CCTAACNG	CCTAACAG
AGGTTGCC	AGTTGCCT
AGTCAGCT	AGTCAGTT
AGTCAGTA	AGTCAGTT
AGTCAGTC	AGTCAGTT
CAGATCTT	CAGAGCTT
CANTACTC	CAGTACTC
CNATCGGT	CATCGGTC
AGAGCCGN	AGAGCGCG
CCAGCCGG	ACAGCCGG
CAATGTCG	AATGTCGT
CAATGTTT	CACTGTTT
CCCTCTCG	CACTCTCG
CAATGTTG	AATGTTGT
AGTCAGTT	AGTCAGTT
CATTTTAC	AATTTTAC
AGTCAGTG	AGTCAGTT
AGAGCTTA	CAGAGCTT
AGTCAGTN	AGTCAGTT
AGAGCTTC	CAGAGCTT
AGAGCTTT	CAGAGCTT
AGAGCTTG	CAGAGCTT
AGTCAGGT	AGTCAGTT
AGAGCTTN	CAGAGCTT
CCTAATAG	CCTAACAG
AGAGCTGC	AGAGCGCG
CCTAATCA	CCTAACAG
AGTCAGNT	AGTCAGTT
CAGTANCT	CAGTACTC
AGGTGAGG	TGGTGAGG
CTGGGCAA	CTGGCCAA
CAGTANTC	CAGTACTC
AGGTGCCT	AGTTGCCT
CATAGGAA	CCTAGGAA
CTGTCCAC	CTGTGCCA
CTGTCCAT	CTGTGCCA
CTGTCCAG	CTGTGCCA
CTGTCCAN	CTGTGCCA
CGCCGACA	CGCACGAC
CTGTCCCA	CTGTGCCA
CGCCGACC	CGCACGAC
CATAGGTC	CATCGGTC
CGCCGACT	CGCACGAC
CGCCGACG	CGCACGAC
CGCCGACN	CGCACGAC
CAGGTGGG	CAGGGGGG
AGTCANTT	AGTCAGTT
AGAGCGAC	AGAGCGCG
AGAGCGAG	AGAGCGCG
AGTCANGT	AGTCAGTT
AGAGCGCA	AGAGCGCG
CTGTCCGG	CGTCCGGG
AGAGCGCC	AGAGCGCG
AGAGCGCT	AGAGCGCG
CCNCCGGC	CCCCGGCA
AGAGCGCG	AGAGCGCG
CAGTCACT	CAGTACTC
AGAGCGCN	AGAGCGCG
CCTAAGAA	CCTAGGAA
CAACACTA	CAACCTAA
AGAGCGTC	AGAGCGCG
CCTAAGAG	CCTAACAG
CCCTCGGC	CCCCGGCA
AGAGCGTG	AGAGCGCG
CCTAAGCA	CCTAACAG
AGAGCGGA	AGAGCGCG
AGAGCGGC	AGAGCGCG
AGTCCACC	GTCCACCT
CAGTCAGT	AGTCAGTT
AGAGCGGT	AGAGCGCG
AGAGCGGG	AGAGCGCG
CATTTGGC	CTTTGGCT
CCTAAGTC	CCAAAGTC
AGAGCGGN	AGAGCGCG
CCAGTACT	CAGTACTC
AGGCACCC	AAGCACCC
AGAGCGNC	AGAGCGCG
CCTAAGGA	CCTAGGAA
AGAGCGNG	AGAGCGCG
CAACATAA	CAACCTAA
CCAGTATG	CCATATGC
AGTCCAGT	AGTCAGTT
CACTTCCA	ACTTCCAT
CCTAANAG	CCTAACAG
CACTTCTC	CACTCTCG
AGTNTGCC	AGTTGCCT
CTTCAAAA	TTCAAAAG
AGGTGGGA	GGTGGGAA
ANCTAAAC	ACTAAACG
AGTCCCGA	ACTCCCGA
CAGTCCCG	CAGGCCCG
AGTCCCGC	AGCCCGCG
CAGATGCT	CAGAGCTT
AGAGCNCG	AGAGCGCG
CAGTCCTC	CAGTACTC
CCCAGGAA	CCTAGGAA
CACTTCGA	CACTCTCG
CACTTCGC	CACTCTCG
CAGTCCGG	CGTCCGGG
CACTTCGT	CACTCTCG
AGAGCNGC	AGAGCGCG
CCCAGGCA	CCCCGGCA
CACTTCGG	CACTCTCG
CAGGGAGG	CAGGGGGG
CACTTCGN	CACTCTCG
CAGTCTCA	CAGTACTC
CCAGGAAA	CCTAGGAA
CCTAANCA	CCTAACAG
CAGTCTCC	CAGTACTC
CCAGGAAC	CCTAGGAA
CAGTCTCT	CAGTACTC
CCAGGAAT	CCTAGGAA
AGGCATAG	GGCATAGA
CCAGGAAG	CCTAGGAA
CAGTCTCN	CAGTACTC
CACTTTCG	CACTCTCG
CCAGGAAN	CCTAGGAA
CACTTTTA	CACTGTTT
CACTTTTC	CACTGTTT
CACTTTTT	CACTGTTT
CACTTTTG	CACTGTTT
CACTTTTN	CACTGTTT
CTCCACCT	GTCCACCT
ANCGTATC	AGCGTATC
CCTACACA	CCTAACAG
CTGCCAAA	CTGGCCAA
CTGCCAAC	CTGGCCAA
CTGCCAAT	CTGGCCAA
CTGCCAAG	CTGGCCAA
AGTCCTCC	ATTCCTCC
CTGCCAAN	CTGGCCAA
CTATGCCA	CTGTGCCA
CAGGGCCC	CAGGCCCG
CAGGGCCG	CAGGCCCG
CAGGGCTT	CAGAGCTT
CTGTCGCC	CTGTGCCA
CAGGGCGG	CAGGGGGG
CTGCCCAA	CTGGCCAA
CTGCCCAT	CGGCCCAT
CACTTGTT	CACTGTTT
CCTACAGA	CCTAACAG
CCTACAGC	CCTAACAG
CCAGGCCC	CAGGCCCG
CCTACAGT	CCTAACAG
CCTACAGG	CCTAACAG
CCTACAGN	CCTAACAG
AGTCCGCG	AGCCCGCG
CCTACCAG	CCTAACAG
AGTCCGGG	CGTCCGGG
CAGAGACT	CAGAGCTT
CTTTCGCT	CTTTGGCT
ANCGTTTA	AACGTTTA
CGCCGTTC	AGCCGTTC
CAGAGATT	CAGAGCTT
CTNACTCG	CTACTCGT
CTTTCGGC	CTTTGGCT
ANAAGCTC	AAAGCTCG
CAACCAAA	CAACCTAA
CAGTCGGT	CATCGGTC
CAACCAAC	CAACCTAA
CAACCAAT	CAACCTAA
CAACCAAG	CAACCTAA
CAACCAAN	CAACCTAA
CAGGGTGG	CAGGGGGG
CAACCATA	CAACCTAA
CTGGGGGG	CAGGGGGG
CAGGGGAG	CAGGGGGG
AGGCAGTT	AGTCAGTT
CTATGGCT	CTTTGGCT
CAGGGGCG	CAGGGGGG
CTCCCATG	TCCCATGC
CCCTTTAC	GCCTTTAC
CCTACTCG	CTACTCGT
CCTACTTG	CCGACTTG
CAACCCAA	CAACCTAA
CAGGGGTG	CAGGGGGG
CAGGGGGA	CAGGGGGG
CAGGGGGC	CAGGGGGG
CAGGGGGT	CAGGGGGG
CAGGGGGG	CAGGGGGG
CAGGGGGN	CAGGGGGG
CAACCCTA	CAACCTAA
CAGGGGNG	CAGGGGGG
CAGAGCAT	CAGAGCTT
CAGAGCAG	TAGAGCAG
CAGAGCCC	CAGGCCCG
CAGAGCCT	CAGAGCTT
CACTGATT	CACTGTTT
CAGAGCTA	CAGAGCTT
CAGAGCTC	CAGAGCTT
CAGAGCTT	CAGAGCTT
CAGAGCTG	CAGAGCTT
CAGAGCTN	CAGAGCTT
CACTGAGG	ACTGAGGA
CAACCTAA	CAACCTAA
CCNAAAGT	CCAAAGTC
CAGAGCGC	AGAGCGCG
CAGAGCGT	CAGAGCTT
CGTCCACC	GTCCACCT
CAGAGCNT	CAGAGCTT
CCNAACAG	CCTAACAG
CAGAGTCT	CAGAGCTT
CCTACGAA	CCTAGGAA
CNACCTAA	CAACCTAA
CGCCGGCA	CCCCGGCA
CCCNCGGC	CCCCGGCA
CCTACGGA	CCTAGGAA
CCNGACTT	CCGACTTG
CAGAGTTA	CAGAGCTT
CAGAGTTC	CAGAGCTT
CAGAGTTT	CAGAGCTT
CAGAGTTG	CAGAGCTT
CAGAGTTN	CAGAGCTT
CTTCCATA	ACTTCCAT
CTTCCATC	ACTTCCAT
CTTCCATT	ACTTCCAT
CGGTGAGG	TGGTGAGG
CTTCCATG	ACTTCCAT
CTTCCATN	ACTTCCAT
CCGAAAGT	CCAAAGTC
CGGTGCCA	CTGTGCCA
CAGGGNGG	CAGGGGGG
CAGAGGCT	CAGAGCTT
CCGAACAG	CCTAACAG
CAGAGGTT	CAGAGCTT
CGTCCAGG	CGTCCGGG
CTGTTCCA	CTGTGCCA
CACTGCTC	CACTCTCG
CTGGNCAA	CTGGCCAA
CAACCTAC	CAACCTAA
CTNGTGCC	CTGTGCCA
CACTGCTT	CACTGTTT
CCAGGGGG	CAGGGGGG
CAACCTAT	CAACCTAA
CAACCTAG	CAACCTAA
CAACCTAN	CAACCTAA
CAACCTCA	CAACCTAA
CTGGNCCA	CTGGCCAA
CGTCCCAT	CGGCCCAT
CAACCTTA	CAACCTAA
CGTGAAAA	CGTAGAAA
CGTGAAAC	CGTAGAAA
CGTGAAAT	CGTAGAAA
CGTGAAAG	CGTAGAAA
CTTTTTAA	GCTTTTTA
CGTGAAAN	CGTAGAAA
CAACCTGA	CAACCTAA
CTTTTTAC	GCTTTTTA
CTTTTTAT	GCTTTTTA
CACTGTAT	CACTGTTT
CGCAAAGT	CCAAAGTC
CTTTTTAG	GCTTTTTA
CTTTTTAN	GCTTTTTA
CAGAGGGG	CAGGGGGG
CCGAACTT	CCGACTTG
CCCTTGGT	ACCTTGGT
CGCCGGGA	CGTCCGGG
CCGCTTGA	CCGACTTG
CGCCGGGC	CGTCCGGG
CCGCTTGC	CCGACTTG
CGCCGGGT	CGTCCGGG
CCGCTTGT	CCGACTTG
CGCCGGGG	CGTCCGGG
CCGCTTGG	CCGACTTG
CGCCGGGN	CGTCCGGG
CCGCTTGN	CCGACTTG
CAGAGNCT	CAGAGCTT
CAGAGNTT	CAGAGCTT
CGTCCCGG	CGTCCGGG
CCGAATTG	CCGACTTG
CCGGCCAA	CTGGCCAA
CTCTTTGG	GTCTTTGG
CGAGCCCA	CGGCCCAT
CCGGCCCA	CGGCCCAT
CCGGCCCG	CAGGCCCG
CACNCTCG	CACTCTCG
CAGGNCCC	CAGGCCCG
CAACCTNA	CAACCTAA
CTCCCGAA	ACTCCCGA
CAGGNCCG	CAGGCCCG
CTCCCGAC	ACTCCCGA
CTCCCGAT	ACTCCCGA
CGCAACGA	CGCACGAC
CACTGTCT	CACTGTTT
CTCCCGAG	ACTCCCGA
CGTCCTGG	CGTCCGGG
CACTGTCG	CACTCTCG
CTCCCGAN	ACTCCCGA
CAACCGAA	CAACCTAA
CGCAACGG	GCAACGGC
CACTGTTA	CACTGTTT
CACTGTTC	CACTGTTT
CACTGTTT	CACTGTTT
CACTGTTG	CACTGTTT
CACTGTTN	CACTGTTT
CACTGTGT	CACTGTTT
CTGTTGCC	CTGTGCCA
CGCAATAC	GCAATACT
CAACCGTA	CAACCTAA
CACTGTNT	CACTGTTT
CCTATACA	CCTAACAG
CCTATATG	CCATATGC
CTTCCTCC	ATTCCTCC
CACTGGTT	CACTGTTT
CCGAAGTC	CCAAAGTC
CCGCTGGC	TCGCTGGC
CCNAAGTC	CCAAAGTC
CCGAAGGG	ACGAAGGG
CGGTGGGA	GGTGGGAA
CACTGNTT	CACTGTTT
CTTCCGGG	CGTCCGGG
CGGCACAT	CGGCCCAT
CGAGCTTA	CAGAGCTT
CGAGCTTC	CAGAGCTT
CGAGCTTT	CAGAGCTT
CGAGCTTG	CAGAGCTT
CGAGCTTN	CAGAGCTT
CGGCACCA	CGGCCCAT
CGAGCGCG	AGAGCGCG
CGGCACGA	CGCACGAC
CGCGACTT	CCGACTTG
CGCGACGA	CGCACGAC
CGGCATAG	GGCATAGA
CCGACATT	CCGACTTG
CCGACATG	CCGACTTG
CAACCNAA	CAACCTAA
CTCTTGGC	CTTTGGCT
CGTCCGAG	CGTCCGGG
CTACACGT	CTACTCGT
CGTCCGCG	CGTCCGGG
CAACCNTA	CAACCTAA
CGTCCGTG	CGTCCGGG
CTCCCGGC	CCCCGGCA
CGTCCGGA	CGTCCGGG
CGTCCGGC	CGTCCGGG
CCTCGGAA	CCTAGGAA
CGTCCGGT	CGTCCGGG
CGTCCGGG	CGTCCGGG
CGTCCGGN	CGTCCGGG
CCTCGGCA	CCCCGGCA
CTGTTGGC	CTTTGGCT
CCTCGGTC	CATCGGTC
CGAAATGC	AGAAATGC
CTTTTGCT	CTTTGGCT
CGCAAGAC	CGCACGAC
CTNGGCCA	CTGGCCAA
CCTATCAG	CCTAACAG
CTTTTGGC	CTTTGGCT
CTACATCG	CTACTCGT
CGCGAGAC	GGCGAGAC
CCGACCTT	CCGACTTG
CCGACCTG	CCGACTTG
CTACATGG	TACATGGA
CGTCCGNG	CGTCCGGG
CGTGAGAA	CGTAGAAA
CCNACTTG	CCGACTTG
CGACGACA	CGCACGAC
CGACGACC	CGCACGAC
CGACGACT	CGCACGAC
CGACGACG	CGCACGAC
CGACGACN	CGCACGAC
CNACTCTC	CACTCTCG
CGAAAGTC	CCAAAGTC
CGAGTACT	CAGTACTC
CGTCCNGG	CGTCCGGG
CNACTCGT	CTACTCGT
CCCCATGC	TCCCATGC
CTTCTACG	GTTCTACG
CCGACTAT	CCGACTTG
CCGACTAG	CCGACTTG
CCNCGGCA	CCCCGGCA
CCGACTCT	CCGACTTG
CCGACTCG	CCGACTTG
CAGGNGGG	CAGGGGGG
CCGACTTA	CCGACTTG
CCGACTTC	CCGACTTG
CCGACTTT	CCGACTTG
CCGACTTG	CCGACTTG
CCGACTTN	CCGACTTG
CCGACTGA	CCGACTTG
CCGACTGC	CCGACTTG
CTTTGACT	CTTTGGCT
CCGACTGT	CCGACTTG
CCGACTGG	CCGACTTG
CCGACTGN	CCGACTTG
CCGACTNT	CCGACTTG
CCGACTNG	CCGACTTG
CCTGTTTA	CACTGTTT
CCTGTTTC	CACTGTTT
CCTGTTTT	CACTGTTT
CCTGTTTG	CACTGTTT
CCGCGGCA	CCCCGGCA
CCGGCTTG	CCGACTTG
CCTGTTTN	CACTGTTT
CTGTGACA	CTGTGCCA
CTGTGACC	CTGTGCCA
CTCTGAAA	TCTGAAAG
CCCCAGCA	CCCCGGCA
CNACTGTT	CACTGTTT
CGCACAAC	CGCACGAC
CGCACACA	CGCACGAC
CCCCAGGC	CCCCGGCA
CGCACACC	CGCACGAC
CCGACGTT	CCGACTTG
CTGCTCGT	CTACTCGT
CCGACGTG	CCGACTTG
CGGCCAAA	CTGGCCAA
CGGCCAAC	CTGGCCAA
CGGCCAAG	CTGGCCAA
CGGCCAAN	CTGGCCAA
CGGCCACA	CGGCCCAT
CGGCCATA	CGGCCCAT
CGGCCATC	CGGCCCAT
CGGCCATT	CGGCCCAT
CGGCCATG	CGGCCCAT
CGGCCATN	CGGCCCAT
CCTGTGCC	CTGTGCCA
CCGACNTT	CCGACTTG
CGCGCCCA	CGGCCCAT
CCGACNTG	CCGACTTG
CGGCCCAA	CGGCCCAT
CGGCCCAC	CGGCCCAT
CGGCCCAT	CGGCCCAT
CGGCCCAG	CGGCCCAT
CCNATATG	CCATATGC
CGGCCCAN	CGGCCCAT
CGGCCCCA	CGGCCCAT
CGGCCCCT	CGGCCCAT
CTTTGAGC	CTTTGGCT
CCTATGAA	CCTAGGAA
CTCCTCGT	CTACTCGT
CCTATGCA	CCATATGC
CGCACACT	CGCACGAC
CCTATGCC	CCATATGC
CGCACACG	CGCACGAC
CCTATGCT	CCATATGC
CGCACACN	CGCACGAC
CCTATGCG	CCATATGC
CCTATGCN	CCATATGC
CTTTGCCA	CTGTGCCA
CTGTGCAA	CTGTGCCA
CTGTGCAC	CTGTGCCA
CTTTGCCT	CTTTGGCT
CTGTGCAT	CTGTGCCA
CGCACAGA	CGCACGAC
CCTATGGA	CCTAGGAA
CCCTGTTT	CACTGTTT
CTAGAAAA	CGTAGAAA
CCCNGGCA	CCCCGGCA
CTAGAAAC	CGTAGAAA
CTAGAAAT	CGTAGAAA
CTAGAAAG	CGTAGAAA
CTAGAAAN	CGTAGAAA
CCCTGGCA	CCCCGGCA
CGTNGAAA	CGTAGAAA
CGAACCTA	CAACCTAA
CTTNTGGC	CTTTGGCT
CTCTGCCA	CTGTGCCA
CGCTAACA	CCTAACAG
CTTCTCGT	CTACTCGT
CGTCTCGG	CGTCCGGG
CTTTGCTA	CTTTGGCT
CTTTGCTC	CTTTGGCT
CTTTGCTT	CTTTGGCT
CTTTGCTG	CTTTGGCT
CTTTGCTN	CTTTGGCT
CTTTGCGC	CTTTGGCT
CTGCTGCC	CTGTGCCA
CGTGCCAA	CTGTGCCA
CGTGCCAC	CTGTGCCA
CCGATATG	CCATATGC
CGTGCCAT	CTGTGCCA
CGTCTTTG	GTCTTTGG
CGTGCCAG	CTGTGCCA
CGTGCCAN	CTGTGCCA
CGTGCCCA	CGGCCCAT
CTGTGCAG	CTGTGCCA
CGGNCCAT	CGGCCCAT
CTGTGCAN	CTGTGCCA
CTGTGCCA	CTGTGCCA
CTGTGCCC	CTGTGCCA
CGGNCCCA	CGGCCCAT
CTGTGCCT	CTGTGCCA
CTGTGCCG	CTGTGCCA
CTTTGTCT	CTTTGGCT
CTCTGTTT	CACTGTTT
CTGTGCCN	CTGTGCCA
CTGTGCTA	CTGTGCCA
CTGTGCTC	CTGTGCCA
CGCACCAC	CGCACGAC
CGGCCCTA	CGGCCCAT
CGGCCCTC	CGGCCCAT
CTGTGCGA	CTGTGCCA
CGGCCCTT	CGGCCCAT
CTGTGCGC	CTGTGCCA
CGGCCCTG	CGGCCCAT
CGGCCCTN	CGGCCCAT
CTTTGTGC	CTTTGGCT
CGGCCCGC	CAGGCCCG
CTGTGCNA	CTGTGCCA
CTGTGCNC	CTGTGCCA
CGGCCCGG	CAGGCCCG
CGGCCCGN	CAGGCCCG
CGGCCCNA	CGGCCCAT
CGGCCCNT	CGGCCCAT
CGCACCGA	CGCACGAC
CGCTACGA	CGCACGAC
CCGATCTT	CCGACTTG
CGCGCGAC	CGCACGAC
CTTCTGGC	CTTTGGCT
CTCTGGAA	TCTGGAAC
CTTTGGAC	CTTTGGCT
CTTTGGAT	CTTTGGCT
CTCTGGCT	CTTTGGCT
CGTGCCGG	CGTCCGGG
CCANAAGT	CCAAAGTC
CTTTGGCA	CTTTGGCT
CCTAGAAC	CCTAGGAA
CTTTGGCC	CTTTGGCT
CCTAGAAT	CCTAGGAA
CTTTGGCT	CTTTGGCT
CCTAGAAG	CCTAGGAA
CTTTGGCG	CTTTGGCT
CCTAGAAN	CCTAGGAA
CTTTGGCN	CTTTGGCT
CCTAGACA	CCTAACAG
CTTTGGTA	CTTTGGCT
CTTTGGTC	CTTTGGCT
CGCACTAC	CGCACGAC
CTTTGGTT	CTTTGGCT
CGGCCTAT	CGGCCCAT
CTTTGGTG	CTTTGGCT
CTTTGGTN	CTTTGGCT
CGGCCTCA	CGGCCCAT
CTTTGGGC	CTTTGGCT
CTTTGGGT	CTTTGGCT
CGTCTGGG	CGTCCGGG
CTGTGTCA	CTGTGCCA
CTTTGGNC	CTTTGGCT
CTGTGTCC	CTGTGCCA
CTTTGGNT	CTTTGGCT
CCTGGAAA	CCTAGGAA
CCTGGAAT	CCTAGGAA
CGCACTGA	CGCACGAC
CCTGGAAG	CCTAGGAA
CTAAAAAT	TAAAAATC
CCTGGAAN	CCTAGGAA
CTAAAATA	TTAAAATA
CGCACGAA	CGCACGAC
CTAGAGCA	TAGAGCAG
CTAGAGCT	CAGAGCTT
CTTTGNCT	CTTTGGCT
CCTGGCCA	CTGGCCAA
CCTAGAGA	CCTAGGAA
CCGATTTG	CCGACTTG
CCGATTGA	CCGACTTG
CTANCTCG	CTACTCGT
CCGATTGC	CCGACTTG
CTACCCGT	CTACTCGT
CGCACGAC	CGCACGAC
CTTTGNGC	CTTTGGCT
CCGATTGT	CCGACTTG
CTGTGGCA	CTGTGCCA
CGCACGAT	CGCACGAC
CCGATTGG	CCGACTTG
CTGTGGCC	CTGTGCCA
CGCACGAG	CGCACGAC
CCGATTGN	CCGACTTG
CTGTGGCT	CTTTGGCT
CGCACGAN	CGCACGAC
CGCACGCA	CGCACGAC
CGCACGCC	CGCACGAC
CCTAGCAA	CCTAGGAA
CGCACGCT	CGCACGAC
CGCACGCG	CGCACGAC
CTACCTAA	CAACCTAA
CGCACGCN	CGCACGAC
CCTAGCAG	CCTAACAG
CGCACGTA	CGCACGAC
CGGCCGAT	CGGCCCAT
CGCACGTC	CGCACGAC
CTGTGGGC	TTGTGGGC
CGAACGAC	CGCACGAC
CGGCCGCA	CGGCCCAT
CGCACGGA	CGCACGAC
CGCACGGC	CGCACGAC
CTACCTCG	CTACTCGT
CGAACGCA	GAACGCAT
CGCACGNA	CGCACGAC
CGCACGNC	CGCACGAC
CGCACNAC	CGCACGAC
CGGCCGGG	CGTCCGGG
CTGTGNCA	CTGTGCCA
CTGTGNCC	CTGTGCCA
CTGCGATC	GTGCGATC
CGCGTATC	AGCGTATC
CGAGGCCC	CAGGCCCG
CGTCGAAA	CGTAGAAA
CGNCACGA	CGCACGAC
CGGGACCA	TCGGGACC
CGGGACCC	TCGGGACC
CTAAACGA	ACTAAACG
CGGGACCT	TCGGGACC
CGCTAGAA	CGTAGAAA
CTAAACGC	ACTAAACG
CGGGACCG	TCGGGACC
CTAAACGT	ACTAAACG
CGGGACCN	TCGGGACC
CCANATGC	CCATATGC
CTAAACGG	ACTAAACG
CCTAGCGA	CCTAGGAA
CTAAACGN	ACTAAACG
CGCACNGA	CGCACGAC
CCTAGTAA	CCTAGGAA
CGTGCGAT	GTGCGATC
CNAGAGCT	CAGAGCTT
CGGCCNAT	CGGCCCAT
CGGCCNCA	CGGCCCAT
CCANAGTC	CCAAAGTC
CTACCGTA	CTACTCGT
CTACCGTC	CTACTCGT
CTACCGTT	CTACTCGT
CGCATATG	CCATATGC
CTACCGTG	CTACTCGT
CTACCGTN	CTACTCGT
CCCCCGCA	CCCCGGCA
CGCATAGA	GGCATAGA
CCCCCGGC	CCCCGGCA
CGCTAGTT	GGCTAGTT
CCTGGGAA	CCTAGGAA
CGCTAGGA	CCTAGGAA
CTAAATGA	TAAATGAC
CGTCGCGG	CGTCCGGG
CTGNCCAA	CTGGCCAA
CGTAAAAA	CGTAGAAA
CGTAAAAC	CGTAGAAA
CGTAAAAT	CGTAGAAA
CGTAAAAG	CGTAGAAA
CGGGATAC	GGGATACA
CTAAAGAT	TAAAGATT
CGGGATCC	GGGGATCC
CTAAAGTC	CCAAAGTC
CCTAGTGA	CCTAGGAA
CGTGCGGG	CGTCCGGG
CGCATCGA	CGCACGAC
CCTAGGAA	CCTAGGAA
CCTAGGAC	CCTAGGAA
CCTAGGAT	CCTAGGAA
CGGCTAGT	GGCTAGTT
CCTAGGAG	CCTAGGAA
CCTAGGAN	CCTAGGAA
CCNTAACA	CCTAACAG
CGGCTCAT	CGGCCCAT
CGTCGGTC	CATCGGTC
CGGCTCCA	CGGCCCAT
CGTCGGGA	CGTCCGGG
CGTCGGGC	CGTCCGGG
CTACTACG	CTACTCGT
CGTCGGGT	CGTCCGGG
CGTCGGGG	CGTCCGGG
CGTCGGGN	CGTCCGGG
CTGTNCCA	CTGTGCCA
CGTAAAAN	CGTAGAAA
CCTTAACA	CCTAACAG
CGTAACAG	CCTAACAG
CTANTCGT	CTACTCGT
CCTAGGCA	CCTAGGAA
CGCATGAC	CGCACGAC
CTAGCCAA	CTGGCCAA
CCTAGGTA	CCTAGGAA
CTACTAGT	CTACTCGT
CCTAGGGA	CCTAGGAA
CCTAGGNA	CCTAGGAA
CTACTCAT	CTACTCGT
CTACTCAG	CTACTCGT
CCTAGNAA	CCTAGGAA
CTACTCCT	CTACTCGT
CTACTCCG	CTACTCGT
CTTTNGCT	CTTTGGCT
CTACTCTA	CTACTCGT
CTACTCTT	CTACTCGT
CTACTCTG	CTACTCGT
CTACTCTN	CTACTCGT
CTACTCGA	CTACTCGT
CTACTCGC	CTACTCGT
CTACTCGT	CTACTCGT
CTTTNGGC	CTTTGGCT
CTACTCGG	CTACTCGT
CTACTCGN	CTACTCGT
CGTCNCGG	CGTCCGGG
CTCCGGCA	CCCCGGCA
CGNCCCAT	CGGCCCAT
CGAGGGGG	CAGGGGGG
CCTTACAG	CCTAACAG
CTAACAGA	CCTAACAG
CTCCGGGA	CGTCCGGG
CTAACAGC	CCTAACAG
CTCCGGGC	CGTCCGGG
CTAACAGT	CCTAACAG
CTCCGGGT	CGTCCGGG
CTAACAGG	CCTAACAG
CTCCGGGG	CGTCCGGG
CTAACAGN	CCTAACAG
CTCCGGGN	CGTCCGGG
CTACTCNT	CTACTCGT
CTACTCNG	CTACTCGT
CTAACCTA	CAACCTAA
CGATAACC	TGATAACC
CTACTTCG	CTACTCGT
CGATAATA	GATAATAT
CCTAGNGA	CCTAGGAA
CGTCNGGG	CGTCCGGG
CTAGCTCG	CTACTCGT
CTTNGGCT	CTTTGGCT
CCGGGACC	TCGGGACC
CCCGACTT	CCGACTTG
CCNTATGC	CCATATGC
CTGTNGCC	CTGTGCCA
CTACTTGT	CTACTCGT
CGAAGAAA	CGTAGAAA
CTAACTCG	CTACTCGT
CTACTGCG	CTACTCGT
CTACTGTA	CTACTCGT
CTACTGTC	CTACTCGT
CCTANACA	CCTAACAG
CTACTGTG	CTACTCGT
CNAAAGTC	CCAAAGTC
CGAAGCTA	GAAGCTAG
CTTCGGCT	CTTTGGCT
CTTCGGTC	CATCGGTC
CCGTAACA	CCTAACAG
CCTTATGC	CCATATGC
CCNAGGAA	CCTAGGAA
CCGAGTTG	CCGACTTG
CCCCTGCA	CCCCGGCA
CGGGCCAA	CTGGCCAA
CGGGCCAT	CGGCCCAT
CGCTCCGG	CGTCCGGG
CGATATTG	GATATTGG
CTACTGTN	CTACTCGT
CGGGCCCA	CGGCCCAT
CGCAGAAA	CGTAGAAA
CGATATGC	CCATATGC
CTACTGGT	CTACTCGT
CGGGCCCG	CAGGCCCG
CGCAGACA	CGCACGAC
CCNTAGGA	CCTAGGAA
CGCAGACC	CGCACGAC
CGCAGACT	CGCACGAC
CGCAGACG	CGCACGAC
CGCAGACN	CGCACGAC
CGTAAGAA	CGTAGAAA
CGATAGAA	CGTAGAAA
CGCTCTCG	CACTCTCG
CGAAGGGA	ACGAAGGG
CGAAGGGC	ACGAAGGG
CGNGCCCA	CGGCCCAT
CTACTNCG	CTACTCGT
CGAAGGGT	ACGAAGGG
CGAAGGGG	ACGAAGGG
CCTANCAG	CCTAACAG
CGAAGGGN	ACGAAGGG
CCGTACTC	CAGTACTC
CCGTACTT	CCGACTTG
CCCCTGGC	CCCCGGCA
CCTTAGGA	CCTAGGAA
CCGAGGAA	CCTAGGAA
CGTGTGCC	CTGTGCCA
CGGCGAGA	GGCGAGAC
CTGGAACA	TCTGGAAC
CTGGAACC	TCTGGAAC
CTGGAACT	TCTGGAAC
CTGGAACG	TCTGGAAC
CTGGAACN	TCTGGAAC
CTCGACTT	CCGACTTG
CGNCCGGG	CGTCCGGG
CGCTCGAC	CGCACGAC
CNTACTCG	CTACTCGT
CTACTNGT	CTACTCGT
CGCAGCGA	CGCACGAC
CGGCGCAT	CGGCCCAT
CCGGGTGA	GCGGGTGA
CNAGTACT	CAGTACTC
CGGCGCCA	CGGCCCAT
CCCCGACA	CCCCGGCA
CTAGTAAC	TTAGTAAC
CTGGACAA	CTGGCCAA
CTGGACCA	CTGGCCAA
CTAGTACT	CAGTACTC
CCGTATGC	CCATATGC
CCGGGGGG	CAGGGGGG
CCGTAGAA	CGTAGAAA
CCGTAGGA	CCTAGGAA
CGTTAGAA	CGTAGAAA
CCCCGAGC	CCCCGGCA
CTACGCGT	CTACTCGT
CCCCGCAA	CCCCGGCA
CCCCGCAC	CCCCGGCA
CCCCGCAT	CCCCGGCA
CCCCGCAG	CCCCGGCA
CCCCGCAN	CCCCGGCA
CCCCGCCA	CCCCGGCA
CNAACCTA	CAACCTAA
CTAGTCGT	CTACTCGT
CCTANGAA	CCTAGGAA
CTAATCGT	CTACTCGT
CGCGGGTG	GCGGGTGA
CCCCGCGC	CCCCGGCA
CGTGGAAA	CGTAGAAA
CTGGATCA	TGGATCAA
CCTNAACA	CCTAACAG
CGATCCGG	CGTCCGGG
CCTTCCAT	ACTTCCAT
CGTACAAA	CGTAGAAA
CGACACGA	CGCACGAC
CTACGTCG	CTACTCGT
CCTNACAG	CCTAACAG
CGCAGGAC	CGCACGAC
CNATATGC	CCATATGC
CCTANGGA	CCTAGGAA
CCANTATG	CCATATGC
CTAGTGCC	CTGTGCCA
CCCCGTCA	CCCCGGCA
CTGNTGCC	CTGTGCCA
CCCCGTGC	CCCCGGCA
CGTGGCCA	CTGGCCAA
CCGANCTT	CCGACTTG
CGTGGCTT	GTGGCTTC
CCGTCCGG	CGTCCGGG
CGTACCGG	CGTCCGGG
CCGTCTTG	CCGACTTG
CGACCCAT	CGGCCCAT
CGACCCTC	GACCCTCA
CGACCCTT	TGACCCTT
CCCCGGAA	CCCCGGCA
CCCCGGAC	CCCCGGCA
CCCCGGAT	CCCCGGCA
CCCCGGAG	CCCCGGCA
CCCCGGAN	CCCCGGCA
CCCCGGCA	CCCCGGCA
CCCCGGCC	CCCCGGCA
CCCCGGCT	CCCCGGCA
CCCCGGCG	CCCCGGCA
CCCCGGCN	CCCCGGCA
CGACCTAA	CAACCTAA
CCCCGGTA	CCCCGGCA
CCCCGGTC	CCCCGGCA
CCTNAGGA	CCTAGGAA
CCCCGGGA	CCCCGGCA
CCCCGGGC	CCCCGGCA
CCGANTTG	CCGACTTG
CTGAAAGA	TCTGAAAG
CTGAAAGC	TCTGAAAG
CTGAAAGT	TCTGAAAG
CGATCGGT	CATCGGTC
CTGAAAGG	TCTGAAAG
CTGAAAGN	TCTGAAAG
CTAGGAAA	CCTAGGAA
CTAGGAAC	CCTAGGAA
CTAGGAAT	CCTAGGAA
CTAGGAAG	CCTAGGAA
CTAGGAAN	CCTAGGAA
CGCTTTTT	GCTTTTTA
CGGGTCTG	GGGTCTGC
CGACCGGG	CGTCCGGG
CGGGTCGT	GGGTCGTA
CCTCAACA	CCTAACAG
CGTACTCA	CAGTACTC
CGTACTCC	CAGTACTC
CGTACTCT	CAGTACTC
CGTACTCN	CAGTACTC
TAGTCAGT	AGTCAGTT
CTGGCAAA	CTGGCCAA
CTCGCCAA	CTGGCCAA
CTGGCAAC	CTGGCCAA
CTGGCAAT	CTGGCCAA
CTGGCAAG	CTGGCCAA
CTGGCAAN	CTGGCCAA
CTTGCCAC	CTGTGCCA
CTGGCACA	CTGGCCAA
CTTGCCAT	CTGTGCCA
CTTGCCAG	CTGTGCCA
CTTGCCAN	CTGTGCCA
CTACNCGT	CTACTCGT
CGTTCCGG	CGTCCGGG
CTTTACCC	TTTACCCT
CCCCGGNA	CCCCGGCA
CCCCGGNC	CCCCGGCA
CGTGGGAA	GGTGGGAA
TTATTAAC	TTAGTAAC
CGGCNCAT	CGGCCCAT
CTAGGCCA	CTGGCCAA
CTAGGCCC	CAGGCCCG
CCCCGNCA	CCCCGGCA
CCCCGNGC	CCCCGGCA
CTACNTCG	CTACTCGT
CGACTCTC	CACTCTCG
CTCTAACA	CCTAACAG
CGACTCGT	CTACTCGT
CTGGCCAA	CTGGCCAA
CGTACGAA	CGTAGAAA
CGTACGAC	CGCACGAC
CCCGCGGC	CCCCGGCA
CTGGCCCG	CAGGCCCG
CGGGTGAA	GCGGGTGA
CTGGCCTA	CTGGCCAA
CGTTCTAC	GTTCTACG
CTGGCCGA	CTGGCCAA
CTCGCTGG	TCGCTGGC
CTGGCCNA	CTGGCCAA
CGGCNCCA	CGGCCCAT
CGACTTGA	CCGACTTG
CGACTTGC	CCGACTTG
CGACTTGT	CCGACTTG
CGACTTGG	CCGACTTG
CTGGCTAA	CTGGCCAA
CGACTTGN	CCGACTTG
CGTTCTGA	GGTTCTGA
CTTTAGCT	CTTTGGCT
CTTTAGGC	CTTTGGCT
CGACTGTT	CACTGTTT
CCTCACAG	CCTAACAG
CNCTAACA	CCTAACAG
CCTTTACA	GCCTTTAC
CCTTTACC	GCCTTTAC
CCTTTACT	GCCTTTAC
CCTTTACG	GCCTTTAC
CGGGTGAC	GCGGGTGA
CCTTTACN	GCCTTTAC
CGGGTGAT	GCGGGTGA
CGGGTGAG	GCGGGTGA
CGGGTGAN	GCGGGTGA
CGTACGGG	CGTCCGGG
CTGGCTCA	CTGGCCAA
CGCANCGA	CGCACGAC
CTGGCTTC	GTGGCTTC
CTGGCGAA	CTGGCCAA
CTGGCGCA	CTGGCCAA
CGTTCGGG	CGTCCGGG
CNTAGAAA	CGTAGAAA
CCTCATCC	ACTCATCC
CTAGGGGG	CAGGGGGG
CTAAGGGG	TAAGGGGC
CTGGCNAA	CTGGCCAA
CGTATAAA	CGTAGAAA
CGTATAAC	GGTATAAC
CNAGGCCC	CAGGCCCG
CTGGCNCA	CTGGCCAA
CGCANGAC	CGCACGAC
CTGACCAA	CTGGCCAA
CCGNACTT	CCGACTTG
CTCAAAAG	TTCAAAAG
CTCAAAGT	CCAAAGTC
CTGACCCT	TGACCCTT
CCTTTTTA	GCTTTTTA
TCATAACC	TGATAACC
CGCNACGA	CGCACGAC
CGGGGATC	GGGGATCC
CTGGTCAA	CTGGCCAA
CTGACTCG	CTACTCGT
CTCTAGGA	CCTAGGAA
CTGGTCCA	CTGGCCAA
CGGACCAT	CGGCCCAT
CTGACTTG	CCGACTTG
CGGACCCA	CGGCCCAT
TATTTTAC	AATTTTAC
CCGCACTT	CCGACTTG
CCGCACGA	CGCACGAC
CCTCAGGA	CCTAGGAA
CTATATGC	CCATATGC
TCATATGC	CCATATGC
CNAGGGGG	CAGGGGGG
CGCTGTTT	CACTGTTT
CNTAGGAA	CCTAGGAA
CNCTAGGA	CCTAGGAA
CCTTTGGC	CTTTGGCT
CGGACTTA	TCGGACTT
CGGACTTC	TCGGACTT
CGGACTTT	TCGGACTT
CGGACTTN	TCGGACTT
CGGACGAC	CGCACGAC
TTATGTAA	TTAGTAAC
CGCTGGCA	TCGCTGGC
CGCTGGCC	TCGCTGGC
CGCTGGCT	TCGCTGGC
CGCTGGCG	TCGCTGGC
CTGGTGAG	TGGTGAGG
CGCTGGCN	TCGCTGGC
CTGGTGCC	CTGTGCCA
CGCCACGA	CGCACGAC
CGTATGAA	CGTAGAAA
TTANAAAT	TTAAAATA
TAGAGAAG	TAGAGCAG
TAGAGACA	TAGAGCAG
TTANAATA	TTAAAATA
TAGAGACT	TGAGACTA
CTNTTGGC	CTTTGGCT
TAGAGATT	TAAAGATT
TAGAGAGA	TAGAGCAG
TAGAGAGC	TAGAGCAG
TAGAGAGT	TAGAGCAG
TAGAGAGG	TAGAGCAG
TAGAGAGN	TAGAGCAG
CGGTACTC	CAGTACTC
CTATCTCG	CTACTCGT
TAGAGCAA	TAGAGCAG
TAGAGCAC	TAGAGCAG
TTAANAAT	TTAAAATA
TTAANATA	TTAAAATA
CTATCGTA	CTACTCGT
CTATCGTC	CTACTCGT
CTATCGTT	CTACTCGT
CTATCGTG	CTACTCGT
CTATCGTN	CTACTCGT
CTATCGGT	CATCGGTC
CCTCCCGA	ACTCCCGA
CCGTGCCA	CTGTGCCA
CGGGGGGA	CAGGGGGG
CGGGGGGC	CAGGGGGG
CGGGGGGT	CAGGGGGG
CGGGGGGN	CAGGGGGG
TCATCGGT	CATCGGTC
CTCGTGCC	CTGTGCCA
CGGATACA	GGGATACA
TAGAGCAT	TAGAGCAG
TAGAGCAG	TAGAGCAG
CCGCCCAT	CGGCCCAT
TAGAGCAN	TAGAGCAG
TAGAGCCA	TAGAGCAG
CGTTTGGC	CTTTGGCT
TAGAGCCG	TAGAGCAG
TAGTTGCC	AGTTGCCT
TAGAGCTA	TAGAGCAG
CGGTATAA	GGTATAAC
TAGAGCTT	CAGAGCTT
TAGAGCTG	TAGAGCAG
TAGAGCGA	TAGAGCAG
CGGATCAA	TGGATCAA
TAGAGCGT	TAGAGCAG
TAGAGCGG	TAGAGCAG
TAGAGCGN	TAGAGCAG
TAGAGCNA	TAGAGCAG
CTTGTGCC	CTGTGCCA
TTATGGGC	TTGTGGGC
CTTGTGGC	CTTTGGCT
CTTGTGGG	TTGTGGGC
CGGTAGAA	CGTAGAAA
CTATTCGT	CTACTCGT
CTTAAAAT	TTAAAATA
CGTAGAAA	CGTAGAAA
CTNTGCCA	CTGTGCCA
CGTAGAAC	CGTAGAAA
CGTAGAAT	CGTAGAAA
CCGNCTTG	CCGACTTG
CCGCCTTG	CCGACTTG
CGTAGAAG	CGTAGAAA
CGTAGAAN	CGTAGAAA
CGTAGACA	CGTAGAAA
TAGAGCNG	TAGAGCAG
TAGAGTAG	TAGAGCAG
TAGAGTCA	TAGAGCAG
CTCTCTCG	CACTCTCG
CNCTCTCG	CACTCTCG
CGTTGAAA	CGTAGAAA
CTATTGGC	CTTTGGCT
CGCNCGAC	CGCACGAC
CTTAACAG	CCTAACAG
CCTCCGGC	CCCCGGCA
CGCCCATA	CGGCCCAT
CGCCCATC	CGGCCCAT
CGCCCATT	CGGCCCAT
CGCCCATG	CGGCCCAT
CGCCCATN	CGGCCCAT
TAGAGGAG	TAGAGCAG
CGTAGATA	CGTAGAAA
TAGAGGCA	TAGAGCAG
CGTAGAGA	CGTAGAAA
CGTAGANA	CGTAGAAA
TAGAGGGG	TAAGGGGC
CGTAGCAA	CGTAGAAA
CCGCCGGC	CCCCGGCA
CTCGGACT	TCGGACTT
CTNCTCGT	CTACTCGT
TAACCCTT	TGACCCTT
CTCTCGTA	CTACTCGT
CTCTCGTC	CTACTCGT
CTCTCGTT	CTACTCGT
CTCTCGTG	CTACTCGT
CTCTCGTN	CTACTCGT
CCTCCGGG	CGTCCGGG
TAGTGAGG	TGGTGAGG
CTCACTCG	CTACTCGT
CGCCCCAT	CGGCCCAT
TCATGAAA	TCTGAAAG
CTNTGGCT	CTTTGGCT
CCTTGGAA	CCTAGGAA
TAACCTAA	CAACCTAA
TAGAGNAG	TAGAGCAG
TAGAGNCA	TAGAGCAG
CCTTGGCT	CTTTGGCT
CCTTGGTA	ACCTTGGT
CCTTGGTC	ACCTTGGT
CCTTGGTT	ACCTTGGT
CGNTAGAA	CGTAGAAA
TACTGAAA	TCTGAAAG
CTTGGCCA	CTGGCCAA
CGTNAGAA	CGTAGAAA
CGTTGCCT	AGTTGCCT
CTTGGCTA	CTTTGGCT
CTTGGCTC	CTTTGGCT
CTTGGCTT	CTTTGGCT
CTTGGCTG	CTTTGGCT
CTTGGCTN	CTTTGGCT
TAGTGCAG	TAGAGCAG
CGGTCCAT	CGGCCCAT
CCTTGGTG	ACCTTGGT
CCTTGGTN	ACCTTGGT
CGGTCCCA	CGGCCCAT
CGGAGAAA	CGTAGAAA
CGCCCGAC	CGCACGAC
CGCCCGCG	AGCCCGCG
CGTAGTAA	CGTAGAAA
CNCAAAGT	CCAAAGTC
CGCCCGGC	CCCCGGCA
CGCCCGGG	CGTCCGGG
TAAGAAAT	TAAAAATC
TAGANCAG	TAGAGCAG
TAAGAATC	TAAAAATC
CGGTCCGG	CGTCCGGG
CTCGGCCA	CTGGCCAA
CTCACGAC	CGCACGAC
TAAGACTA	TGAGACTA
TTACAAAA	TTCAAAAG
CGGTCTGC	GGGTCTGC
TTACAAAT	TTAAAATA
TCCCGATG	TCCCATGC
TTAGAAAC	TTAGTAAC
TTAGAAAT	TTAAAATA
TTAGAACA	TTAGTAAC
TTACAATA	TTAAAATA
TTAGAACC	TTAGTAAC
TACTGAGG	ACTGAGGA
CGGAGCTT	CAGAGCTT
TTAGAACT	TTAGTAAC
TTAGAACG	TTAGTAAC
TTAGAACN	TTAGTAAC
TTAGAATA	TTAAAATA
CCTCTCGA	CACTCTCG
CCTCTCGC	CACTCTCG
CCTCTCGT	CACTCTCG
CCTCTCGG	CACTCTCG
CCTCTCGN	CACTCTCG
TAAGATTA	TAAAGATT
TAAGATTC	TAAAGATT
TAAGATTT	TAAAGATT
TAAGATTG	TAAAGATT
TAAGATTN	TAAAGATT
TAAGATGA	TAAATGAC
CGTTGGCT	CTTTGGCT
TTAGACTA	TGAGACTA
TAAGAGAT	TAAAGATT
CCCAAAGT	CCAAAGTC
TAAGAGCA	TAGAGCAG
TTAGATAA	TTAGTAAC
CGGTCGTA	GGGTCGTA
CTCGGTCA	CATCGGTC
CTCGGTCC	CATCGGTC
CCCAACAG	CCTAACAG
TAAGAGGC	TAAGGGGC
CTCGGTCT	CATCGGTC
CTCGGTCG	CATCGGTC
TCCCGTGC	TCCCATGC
TAAGAGGG	TAAGGGGC
CTCGGTCN	CATCGGTC
TAGTGGGC	TTGTGGGC
CCTNGGAA	CCTAGGAA
CTTGGGCT	CTTTGGCT
TCCCGGCA	CCCCGGCA
TCTGAAAA	TCTGAAAG
TCATGGAC	TACATGGA
TCTGAAAT	TCTGAAAG
TCATGGAT	TACATGGA
TCTGAAAG	TCTGAAAG
TCATGGAG	TACATGGA
TCTGAAAN	TCTGAAAG
TCATGGAN	TACATGGA
CGTAGNAA	CGTAGAAA
TCTGAACC	TCTGGAAC
TCTGAACT	TCTGGAAC
TTAGAGCA	TAGAGCAG
TCTGAACN	TCTGGAAC
TCTGAATA	TCTGAAAG
TCTGAATG	TCTGAAAG
TCTGAAGA	TCTGAAAG
TCTGAAGC	TCTGAAAG
CTTACAGG	ATTACAGG
TCTGAAGT	TCTGAAAG
CGNTCCGG	CGTCCGGG
TCTGAAGG	TCTGAAAG
TCTGAAGN	TCTGAAAG
TCTGAANA	TCTGAAAG
TAAGCACC	AAGCACCC
TCTGAANG	TCTGAAAG
TCTGACAA	TCTGAAAG
TCTGACAG	TCTGAAAG
TAAGCAGA	TAGAGCAG
TAAGCAGC	TAGAGCAG
CTTACCCT	TTTACCCT
TAAGCAGT	TAGAGCAG
TAAGCAGG	TAGAGCAG
CNGGCCAA	CTGGCCAA
TAAGCAGN	TAGAGCAG
TCTGACTT	TCGGACTT
CNGGCCCA	CGGCCCAT
TCCGCATG	TCCCATGC
CNGGCCCG	CAGGCCCG
CGNACGAC	CGCACGAC
TCTGATAA	TCTGAAAG
TAGANGCA	TAGAGCAG
CTCGGGAC	TCGGGACC
TCTGATAG	TCTGAAAG
TTAGCAAC	TTAGTAAC
TCCCNATG	TCCCATGC
CTTACTCG	CTACTCGT
TACTGTTT	CACTGTTT
CTCATATG	CCATATGC
TAGNAGCA	TAGAGCAG
TAACTCAG	AACTCAGT
TCTGAGAG	TCTGAAAG
TACTGGAC	TACATGGA
TACTGGAT	TACATGGA
TACTGGAG	TACATGGA
TACTGGAN	TACATGGA
TCTGAGGA	ACTGAGGA
TTACATGG	TACATGGA
TCTGANAA	TCTGAAAG
TAAGCTAG	GAAGCTAG
TTAGCTAA	TTAGTAAC
TCTGANAG	TCTGAAAG
TAAGCTCG	AAAGCTCG
CGTNCCGG	CGTCCGGG
TAANTGAC	TAAATGAC
CCCAAGTC	CCAAAGTC
CTCATCCA	ACTCATCC
CTCATCCC	ACTCATCC
CGGTTCTG	GGTTCTGA
CTCATCCT	ACTCATCC
TCTGCAAA	TCTGAAAG
CTCATCCG	ACTCATCC
TCTGCAAC	TCTGGAAC
CTCATCCN	ACTCATCC
TCTGCAAG	TCTGAAAG
CGTANAAA	CGTAGAAA
TTACAGGA	ATTACAGG
TTACAGGC	ATTACAGG
TTACAGGT	ATTACAGG
TCCGCTGG	TCGCTGGC
TTACAGGG	ATTACAGG
TTACAGGN	ATTACAGG
TAAGCGGC	TAAGGGGC
TAACTGAC	TAAATGAC
TCCCNTGC	TCCCATGC
TAAGCGGG	TAAGGGGC
TTAGTAAA	TTAGTAAC
TTAGTAAC	TTAGTAAC
TTAGTAAT	TTAGTAAC
TTAGTAAG	TTAGTAAC
TTAGTAAN	TTAGTAAC
TTAGTACA	TTAGTAAC
TTAGTACC	TTAGTAAC
TTAGTACT	TTAGTAAC
TTAGTACG	TTAGTAAC
TTAGTACN	TTAGTAAC
TTAGTATA	TTAGTAAC
TTAGTATC	TTAGTAAC
TTAGTAGA	TTAGTAAC
TTAGTAGC	TTAGTAAC
TCTGCTGG	TCGCTGGC
CGTNCGGG	CGTCCGGG
TCTGCGAA	TCTGGAAC
TTANTAAC	TTAGTAAC
TAGCACCC	AAGCACCC
TTAGTANA	TTAGTAAC
TTAGTANC	TTAGTAAC
TCNTGAAA	TCTGAAAG
TTAGTCAA	TTAGTAAC
TTAGTCAC	TTAGTAAC
CNCATATG	CCATATGC
CGAGAAAA	CGTAGAAA
CGAGAAAC	CGTAGAAA
TAAGTAAC	TTAGTAAC
CGAGAAAT	CGTAGAAA
CGAGAAAG	CGTAGAAA
CGAGAAAN	CGTAGAAA
TATGAAAG	TCTGAAAG
TCTNGAAA	TCTGAAAG
TANATGAC	TAAATGAC
TTAGTTAA	TTAGTAAC
TCTNGAAC	TCTGGAAC
TTAGTTAC	TTAGTAAC
TAANGATT	TAAAGATT
TCCTAACA	CCTAACAG
TCTGTAAA	TCTGAAAG
TCTGTAAC	TCTGGAAC
CCTGAAAG	TCTGAAAG
TCTGTAAG	TCTGAAAG
CCTGAACA	CCTAACAG
TTAGTGAA	TTAGTAAC
TTAGTGAC	TTAGTAAC
TANATGGA	TACATGGA
TCCAAAAG	TTCAAAAG
CNCACGAC	CGCACGAC
TAGCATGG	TACATGGA
TAGCAGCA	TAGAGCAG
CGTANGAA	CGTAGAAA
TCAACCTA	CAACCTAA
TAACGATT	TAAAGATT
TTAGTGGG	TTGTGGGC
CGAGACTA	TGAGACTA
TTAGTNAA	TTAGTAAC
TTAGTNAC	TTAGTAAC
TTACCCTA	TTTACCCT
TTACCCTC	TTTACCCT
TAAGTGAC	TAAATGAC
TTACCCTG	TTTACCCT
TAACGCAT	GAACGCAT
TTACCCTN	TTTACCCT
CCTGACAG	CCTAACAG
TCCAAAGT	CCAAAGTC
TAAGTGGC	TAAGGGGC
CCTGACTT	CCGACTTG
TCTNGGAA	TCTGGAAC
TAAGTGGG	TAAGGGGC
TAGGACTT	TCGGACTT
TAGGATCA	TGGATCAA
TANAGATT	TAAAGATT
TCTAAAAT	TTAAAATA
TCTAAAAG	TCTGAAAG
TCTAAACG	ACTAAACG
TCCTATGC	TCCCATGC
TTCAGAAA	TTCAAAAG
TTAGGAAC	TTAGTAAC
TTCAGAAG	TTCAAAAG
TACCATGC	TCCCATGC
TCAGAAAG	TCTGAAAG
TACCATGG	TACATGGA
TAAGGATT	TAAAGATT
TANAGCAG	TAGAGCAG
TAAGGAGC	TAAGGGGC
TAAGGAGG	TAAGGGGC
TACGAAGG	ACGAAGGG
TAACGTTT	AACGTTTA
TCTAAAGA	TCTGAAAG
TCNTGGAA	TCTGGAAC
TCTAAAGC	TCTGAAAG
TCTAAAGT	TCTGAAAG
TCTAAAGG	TCTGAAAG
TCTAAAGN	TCTGAAAG
CTTATGGC	CTTTGGCT
TAANGGGC	TAAGGGGC
TAANGGGG	TAAGGGGC
TATGAGCA	TAGAGCAG
TCCAATGC	TCCCATGC
TCTAACAG	CCTAACAG
TCAGACTA	TGAGACTA
CNCTGTTT	CACTGTTT
TCAGACTT	TCGGACTT
TCGCCATG	TCCCATGC
TCTGTGAA	TCTGGAAC
CGAGAGCT	CAGAGCTT
TAGGAGCA	TAGAGCAG
TCTGTGCC	CTGTGCCA
TCCTAGGA	CCTAGGAA
TCAGAGCA	TAGAGCAG
TCAGAGCT	CAGAGCTT
TTAGGTAA	TTAGTAAC
CGNAGAAA	CGTAGAAA
TAAGGCGC	TAAGGGGC
TAAGGCGG	TAAGGGGC
CNGACTTG	CCGACTTG
TAACGGGC	TAAGGGGC
TCGNTGGC	TCGCTGGC
TAACGGGG	TAAGGGGC
TAGCCCGC	AGCCCGCG
CNGTACTC	CAGTACTC
TCTGTGGG	TTGTGGGC
TCAACGGC	GCAACGGC
TCGCCTGG	TCGCTGGC
TTCAGTAA	TTAGTAAC
TTACTAAC	TTAGTAAC
TCAGTAAC	TTAGTAAC
TCAGTACT	CAGTACTC
TAAGGTGC	TAAGGGGC
TAAGGTGG	TAAGGGGC
TAAGGGAC	TAAGGGGC
TTAGGGGC	TAAGGGGC
TAAGGGAG	TAAGGGGC
TTANGTAA	TTAGTAAC
TAAGGGCA	TAAGGGGC
TAAGGGCC	TAAGGGGC
TAAGGGCT	TAAGGGGC
TAAGGGCG	TAAGGGGC
CNTCCGGG	CGTCCGGG
CGTCACGA	CGCACGAC
TAAGGGCN	TAAGGGGC
CTNGCCAA	CTGGCCAA
TAAGGGTC	TAAGGGGC
TAAGGGTG	TAAGGGGC
TAAGGGGA	TAAGGGGC
TCCTCATG	TCCCATGC
TAAGGGGC	TAAGGGGC
TAAGGGGT	TAAGGGGC
TACCCATG	TCCCATGC
TACGATGG	TACATGGA
TCGCCGGC	TCGCTGGC
TACGAGCA	TAGAGCAG
TCCGGAAC	TCTGGAAC
TCCGGACC	TCGGGACC
TCTGGAAC	TCTGGAAC
TCCGGACT	TCGGACTT
TCTGGAAT	TCTGGAAC
TCAGCCGG	ACAGCCGG
TCTGGAAN	TCTGGAAC
TCTGGACA	TCTGGAAC
TCTGGACG	TCTGGAAC
CNGGGGGG	CAGGGGGG
TCTGGACN	TCTGGAAC
TAAGGGGG	TAAGGGGC
TCTGGATA	TCTGGAAC
TAAGGGGN	TAAGGGGC
TCTGGATC	TCTGGAAC
TAAGGGNC	TAAGGGGC
TTACTCGT	CTACTCGT
TCCACATG	TCCCATGC
TAAGGGNG	TAAGGGGC
TCTGGAGA	TCTGGAAC
TCGNGACC	TCGGGACC
TCTGGAGC	TCTGGAAC
TCGNGACT	TCGGACTT
CGTCACGG	CGTCCGGG
TTAGNAAC	TTAGTAAC
TCAGCTGG	TCGCTGGC
TANAGGGG	TAAGGGGC
TAAGGNGC	TAAGGGGC
TAAGGNGG	TAAGGGGC
TCCACCTA	GTCCACCT
TCCACCTC	GTCCACCT
TCCACCTT	GTCCACCT
TCCACCTG	GTCCACCT
TCCACCTN	GTCCACCT
TAGCCGTT	AGCCGTTC
TCTGGANA	TCTGGAAC
TCTGGANC	TCTGGAAC
TAGGCAGA	TAGAGCAG
TAGGCAGC	TAGAGCAG
TAGGCAGT	TAGAGCAG
TCAATACT	GCAATACT
TAGGCAGG	TAGAGCAG
TCTGGCAA	TCTGGAAC
TAGGCAGN	TAGAGCAG
TCTGGCAC	TCTGGAAC
CNGTAGAA	CGTAGAAA
TCTGGCCA	CTGGCCAA
TAGGCCCG	CAGGCCCG
TTAGNTAA	TTAGTAAC
TCTGGTAA	TCTGGAAC
TCTGGTAC	TCTGGAAC
TACCCTCA	GACCCTCA
CGTCAGAA	CGTAGAAA
TACCCTTA	TGACCCTT
TACCCTTC	TGACCCTT
TACCCTTT	TGACCCTT
TCGGAAAG	TCTGAAAG
TACCCTTG	TGACCCTT
TACCCTTN	TGACCCTT
TCGCTAGC	TCGCTGGC
CGTCAGTT	AGTCAGTT
TCGCTAGG	TCGCTGGC
CGTCAGGG	CGTCCGGG
CNTGTGCC	CTGTGCCA
TCGNGGAC	TCGGGACC
TTCANAAA	TTCAAAAG
TTCANAAG	TTCAAAAG
TCCGGGAC	TCGGGACC
TCGCTCGC	TCGCTGGC
TCGGAACA	TCTGGAAC
TCGCTCGG	TCGCTGGC
TCGGAACG	TCTGGAAC
TCGGAACN	TCTGGAAC
TCGGAATT	TCGGACTT
TCGAAAGA	TCTGAAAG
TCGAAAGC	TCTGAAAG
TCGAAAGT	TCTGAAAG
TCGGACAT	TCGGACTT
TCGAAAGG	TCTGAAAG
TCGAAAGN	TCTGAAAG
TCGGACCA	TCGGGACC
TACAAAAT	TAAAAATC
TACAAAAG	TTCAAAAG
CNGTCCGG	CGTCCGGG
TACAAATC	TAAAAATC
TCNGAAAG	TCTGAAAG
TCTGGGAA	TCTGGAAC
TCGGACCC	TCGGGACC
TCGGACCG	TCGGGACC
TCGGACCN	TCGGGACC
TCGGACTA	TCGGACTT
TCGGACTC	TCGGACTT
TCTACCCT	TTTACCCT
TCGGACTT	TCGGACTT
TCGGACTG	TCGGACTT
TCGGACTN	TCGGACTT
TCGGACGT	TCGGACTT
TCGGACNT	TCGGACTT
TCGGATCA	TGGATCAA
TCGGATCT	TCGGACTT
TAGCTGGC	TCGCTGGC
TCGGATTA	TCGGACTT
TCGGATTC	TCGGACTT
TTAAAAAA	TTAAAATA
TCGGATTT	TCGGACTT
TTAAAAAC	TTAAAATA
TCGGATTG	TCGGACTT
TCGAACTT	TCGGACTT
TCGGATTN	TCGGACTT
TTAAAAAN	TTAAAATA
TTAAAACA	TTAAAATA
TCGCTTGC	TCGCTGGC
TTAAAACT	TTAAAATA
TCGCTTGG	TCGCTGGC
TTAAAATA	TTAAAATA
TAAGNGGC	TAAGGGGC
TCAGGAAC	TCTGGAAC
TAAGNGGG	TAAGGGGC
TACGCTGG	TCGCTGGC
TCGCTGAC	TCGCTGGC
TCAGGACC	TCGGGACC
TCGCTGAG	TCGCTGGC
TCAGGACT	TCGGACTT
TCGCTGCA	TCGCTGGC
TCAATGAC	TAAATGAC
TCGCTGCC	TCGCTGGC
TCGCTGCT	TCGCTGGC
TCGCTGCG	TCGCTGGC
TCGCTGCN	TCGCTGGC
TCNGACTT	TCGGACTT
TCGCTGTC	TCGCTGGC
TCGCTGTG	TCGCTGGC
TCGCTGGA	TCGCTGGC
TCGCTGGC	TCGCTGGC
TCGCTGGT	TCGCTGGC
TCGCTGGG	TCGCTGGC
TCGCTGGN	TCGCTGGC
TCTACTCG	CTACTCGT
TCGCTGNC	TCGCTGGC
TCTGGNAA	TCTGGAAC
TCTGGNAC	TCTGGAAC
CNTGGCCA	CTGGCCAA
TTAAAATT	TTAAAATA
TTAAAATG	TTAAAATA
TCGGAGAC	TCGGGACC
TTAAAATN	TTAAAATA
TTAAAAGC	TTCAAAAG
GAANCTAG	GAAGCTAG
TCCATATG	CCATATGC
TTAAAAGG	TTCAAAAG
TCNCATGC	TCCCATGC
TTAAAAGN	TTCAAAAG
TCGGAGCT	TCGGACTT
TTAAAANA	TTAAAATA
TTAAAANT	TTAAAATA
TAGCGCAG	TAGAGCAG
TCGGAGTT	TCGGACTT
TATCAAAA	TTCAAAAG
TTAAACAT	TTAAAATA
TACAATGA	TAAATGAC
TACAATGG	TACATGGA
TCTGNAAA	TCTGAAAG
TCTGNAAC	TCTGGAAC
TCTGNAAG	TCTGAAAG
TTAAACTA	TTAAAATA
TNAGGGGC	TAAGGGGC
TCGCTGNG	TCGCTGGC
TCAGGCCC	CAGGCCCG
GAANCGCA	GAACGCAT
TCGGANCT	TCGGACTT
TAGCGTAT	AGCGTATC
TTCCAAAA	TTCAAAAG
TCGGANTT	TCGGACTT
TTCCAAAG	TTCAAAAG
TTCAAAAA	TTCAAAAG
TTCAAAAC	TTCAAAAG
TAANAAAT	TAAAAATC
TTCAAAAG	TTCAAAAG
TTCAAAAN	TTCAAAAG
TTCAAACA	TTCAAAAG
TATGTCGT	AATGTCGT
TTCAAACG	TTCAAAAG
TAANAATC	TAAAAATC
TAAAAAAC	TAAAAATC
TTCAAATG	TTCAAAAG
TAAAAAAT	TAAAAATC
TCGGCACC	TCGGGACC
TCGGCACT	TCGGACTT
TTCAAAGA	TTCAAAAG
TTCAAAGC	TTCAAAAG
TTCAAAGT	TTCAAAAG
TTCAAAGG	TTCAAAAG
TTCAAAGN	TTCAAAAG
TTCAAANA	TTCAAAAG
TTCAAANG	TTCAAAAG
TTCAACAA	TTCAAAAG
TTCCACCT	GTCCACCT
TTCAACAG	TTCAAAAG
TTAAATAA	TTAAAATA
TTAAATAC	TTAAAATA
TTAAATAT	TTAAAATA
TATGTTGT	AATGTTGT
TTAAATAG	TTAAAATA
TTAAATAN	TTAAAATA
TACAAGAT	TAAAGATT
TCGCTNGC	TCGCTGGC
TCTCTGGC	TCGCTGGC
TCGGCCCA	CGGCCCAT
TCGCTNGG	TCGCTGGC
TTAAATTA	TTAAAATA
TTAAATGA	TAAATGAC
TCGGCCTT	TCGGACTT
TCCATGCA	TCCCATGC
TCCATGCC	TCCCATGC
TCCATGCT	TCCCATGC
TCCATGCG	TCCCATGC
TCCATGCN	TCCCATGC
TACAAGGA	TACATGGA
TCAGGGAC	TCGGGACC
TTCAATAA	TTCAAAAG
TAGNGCAG	TAGAGCAG
TAAAAACA	TAAAAATC
CNCGACTT	CCGACTTG
TCTGNGAA	TCTGGAAC
TCGCGACC	TCGGGACC
TAAAAACC	TAAAAATC
TCGCGACT	TCGGACTT
TAAAAACT	TAAAAATC
TTCAATAG	TTCAAAAG
TAAAAACG	TAAAAATC
TAAAAACN	TAAAAATC
TCCATGGA	TACATGGA
TAAAAATC	TAAAAATC
TATGTGGG	TTGTGGGC
TACCTTGG	ACCTTGGT
TAAAAATG	TAAAAATC
TTCCATGC	TCCCATGC
TAAAAATN	TAAAAATC
TCAAGATT	TAAAGATT
TAAAAAGC	TAAAAATC
TAAAAAGT	TAAAAATC
TAAAAANC	TAAAAATC
TCGGCTTA	TCGGACTT
TAAAAANT	TAAAAATC
TCGGCTTC	TCGGACTT
TCGGCTTT	TCGGACTT
TCGGCTTG	TCGGACTT
TCGGCTTN	TCGGACTT
TAAAACAT	TAAAAATC
CNGAGCTT	CAGAGCTT
TTCAAGAA	TTCAAAAG
TCGGCTGG	TCGCTGGC
TTCAAGAG	TTCAAAAG
TCGAAGGG	ACGAAGGG
TAAAACTC	TAAAAATC
TCAGGGGC	TAAGGGGC
TCCTTTAC	GCCTTTAC
TCGGCGAC	TCGGGACC
TCAGGGGG	CAGGGGGG
TTACGTAA	TTAGTAAC
TANGGGGC	TAAGGGGC
TATGGAAC	TCTGGAAC
TAATAAAT	TAAAAATC
TAATAACC	TGATAACC
TTAAAGTA	TTAAAATA
TAANATGA	TAAATGAC
TTCAANAA	TTCAAAAG
TAATAATC	TAAAAATC
TTCAANAG	TTCAAAAG
TCTNAAAG	TCTGAAAG
TAATAAGA	AATAAGAA
TCTCGAAA	TCTGAAAG
TCTCGAAC	TCTGGAAC
TATCATGG	TACATGGA
TACCTGGA	TACATGGA
TTAAANAT	TTAAAATA
TCNCCATG	TCCCATGC
TTAAANTA	TTAAAATA
TTCACAAA	TTCAAAAG
TTCACAAG	TTCAAAAG
TAAAATAA	TTAAAATA
TTCCCATG	TCCCATGC
TAAAATAC	TTAAAATA
TAAAATAG	TTAAAATA
TAAAATAN	TTAAAATA
TAAAATCA	TAAAAATC
TAAAATCC	TAAAAATC
TAAAATCT	TAAAAATC
TAAAATCG	TAAAAATC
TAAAATCN	TAAAAATC
TCGGTACC	TCGGGACC
TAAAATTA	TAAAGATT
TCGGTACT	TCGGACTT
TAAAATTT	TAAAGATT
TAAAATTG	TAAAGATT
TAAAATTN	TAAAGATT
TAAAATGA	TAAATGAC
TAANAGAT	TAAAGATT
TAGGTGAG	TGGTGAGG
CNTCGGTC	CATCGGTC
TTCACCCT	TTTACCCT
TCCTTGGT	ACCTTGGT
TCGGTCTT	TCGGACTT
TTAACAAT	TTAAAATA
TACACAAT	ACACAATG
TATGGGGC	TAAGGGGC
TTAACATA	TTAAAATA
GAANGCAT	GAACGCAT
TAAAAGAC	TAAATGAC
GAANGCTA	GAAGCTAG
TAAAAGTC	TAAAAATC
TCGGTGAC	TCGGGACC
TCAAGGGG	TAAGGGGC
TCGGTGAG	TGGTGAGG
TAAAANAT	TAAAAATC
TAATATGA	TAAATGAC
TACGTTTA	AACGTTTA
TCGGTGGC	TCGCTGGC
TAATAGAT	TAAAGATT
TTAACCCT	TTTACCCT
TANCATGG	TACATGGA
TCGCGTGG	TCGCTGGC
TCTCGGAA	TCTGGAAC
TCGCGGAC	TCGGGACC
TACNTGGA	TACATGGA
TCGCGGCA	TCGCTGGC
TCGCGGCC	TCGCTGGC
TCGCGGCT	TCGCTGGC
TCGCGGCG	TCGCTGGC
TCGCGGCN	TCGCTGGC
TCGGGACA	TCGGGACC
TCGGGACC	TCGGGACC
TCGCGGGC	TCGCTGGC
TCGGGACG	TCGGGACC
TCGGGACN	TCGGGACC
TCGGGATC	TCGGGACC
TAGGGACC	TCGGGACC
TCGGGAGC	TCGGGACC
TCGACCCT	TGACCCTT
TCGGGANC	TCGGGACC
TCCTGAAA	TCTGAAAG
TCGGGCAC	TCGGGACC
CNTTTGGC	CTTTGGCT
TACGTGGA	TACATGGA
TCGGGCCA	TCGGGACC
TCGGGCCC	TCGGGACC
TCGGGCCT	TCGGGACC
TCGGGCCG	TCGGGACC
TCGGGCCN	TCGGGACC
TAAAANTC	TAAAAATC
TAGGGCAG	TAGAGCAG
TCGGGCTT	TCGGACTT
CNGTGCCA	CTGTGCCA
TAAACAAT	TAAAAATC
TACACTGG	TACATGGA
TCCNATGC	TCCCATGC
TTTTACCC	TTTACCCT
TGANGACT	TGAGACTA
TCGGGTAC	TCGGGACC
TCGGGTCC	TCGGGACC
TTCATAAA	TTCAAAAG
TCGACTTA	TCGGACTT
TCGACTTC	TCGGACTT
TTCATAAG	TTCAAAAG
TCGACTTT	TCGGACTT
TCNGCTGG	TCGCTGGC
TCGGGTGA	GCGGGTGA
TCGACTTN	TCGGACTT
TAAACATC	TAAAAATC
TAAACATT	TAAAGATT
TACGGACT	TCGGACTT
TCGACTGG	TCGCTGGC
TCGGGGAC	TCGGGACC
TCGGGGCC	TCGGGACC
TTCCTCCA	ATTCCTCC
TTCCTCCC	ATTCCTCC
TTCCTCCT	ATTCCTCC
TTCCTCCG	ATTCCTCC
TTCCTCCN	ATTCCTCC
TAGTAACA	TTAGTAAC
TAGTAACC	TTAGTAAC
TAGTAACT	TTAGTAAC
TAGTAACG	TTAGTAAC
TCGGGNAC	TCGGGACC
TAGTAACN	TTAGTAAC
TCGGGNCC	TCGGGACC
TCTAGAAA	TCTGAAAG
TCTAGAAC	TCTGGAAC
TCGGNACC	TCGGGACC
TCGGNACT	TCGGACTT
TAGGGGCA	TAAGGGGC
TAGGGGCC	TAAGGGGC
TAGGGGCT	TAAGGGGC
TAGGGGCG	TAAGGGGC
TAGGGGCN	TAAGGGGC
TACACGGA	TACATGGA
TAGGGGGC	TAAGGGGC
TAAACTGA	TAAATGAC
TCCTGGAA	TCTGGAAC
TCCTGGCA	TCGCTGGC
TCCTGGCC	TCGCTGGC
TAAACGAC	TAAATGAC
TCCTGGCT	TCGCTGGC
TAAACGAT	TAAAGATT
TCCTGGCG	TCGCTGGC
TCCTGGCN	TCGCTGGC
TTAATAAC	TTAGTAAC
TTAATAAT	TTAAAATA
TCTAGTAA	TTAGTAAC
TAGTACTC	CAGTACTC
TTAATATA	TTAAAATA
TTATAAAT	TTAAAATA
TTATAACA	TTAGTAAC
TACGGGAC	TCGGGACC
TTATAACT	TTAGTAAC
TTATAACG	TTAGTAAC
TTATAACN	TTAGTAAC
TAGGGGGG	CAGGGGGG
TCCNCATG	TCCCATGC
TAGTAGCA	TAGAGCAG
TTATAATA	TTAAAATA
TACATAGA	TACATGGA
TACGGGGC	TAAGGGGC
TACATAGG	TACATGGA
TCGGNCTT	TCGGACTT
TTATACCC	TTTACCCT
TCNCTGGC	TCGCTGGC
TTCATGGA	TACATGGA
TCGCNTGG	TCGCTGGC
TAGAAAAT	TAAAAATC
TCGATAAC	TGATAACC
TCCCAATG	TCCCATGC
TAATTATG	AATTATGT
TCCCAAGC	TCCCATGC
TGGTTAGG	TGGTGAGG
TGGTTCAA	TGGATCAA
TCGCNGGC	TCGCTGGC
TGGTTCTG	GGTTCTGA
TCTTAAAG	TCTGAAAG
CNTTGGCT	CTTTGGCT
TACATCGA	TACATGGA
TACTAAAC	ACTAAACG
TACATCGG	TACATGGA
TTTTCCCT	TTTACCCT
TCGATCAA	TGGATCAA
TAGAAATC	TAAAAATC
TAGAAATG	AGAAATGC
TCCCACTG	TCCCATGC
TCCCACGC	TCCCATGC
TGGTTGAG	TGGTGAGG
TAGAACAG	TAGAGCAG
TAAATAAC	TAAATGAC
TAAATAAT	TAAAAATC
TAAATACA	TAAATGAC
TAAATACC	TAAATGAC
TAAATACT	TAAATGAC
TAAATACG	TAAATGAC
TAAATACN	TAAATGAC
TAAATATC	TAAAAATC
TAAATATT	TAAAGATT
TAAATAGA	TAAATGAC
CNCCCGGC	CCCCGGCA
TAAATCAC	TAAATGAC
TCCCATAC	TCCCATGC
TCTTACCC	TTTACCCT
TACATTGA	TACATGGA
TCCCATAG	TCCCATGC
TACATTGG	TACATGGA
TCCCATCA	TCCCATGC
TCCCATCC	TCCCATGC
TCCCATCT	TCCCATGC
TAAATCGA	TAAATGAC
TCCCATCG	TCCCATGC
TCCCATCN	TCCCATGC
TCCCATTC	TCCCATGC
TCCCATTG	TCCCATGC
TCCCATGA	TCCCATGC
TCCCATGC	TCCCATGC
TCCCATGT	TCCCATGC
TCCCATGG	TCCCATGC
TCCCATGN	TCCCATGC
TCCCATNC	TCCCATGC
TCCCATNG	TCCCATGC
TTAATGAC	TAAATGAC
TCCCAGCA	TCCCATGC
TCCCAGCC	TCCCATGC
TCCCAGCT	TCCCATGC
TCCCAGCG	TCCCATGC
TCCCAGCN	TCCCATGC
TAATTTTA	AATTTTAC
TCGGNGAC	TCGGGACC
TGGTGAAG	TGGTGAGG
TGGNATCA	TGGATCAA
TGGTGACG	TGGTGAGG
TCGTACTT	TCGGACTT
TCACAATG	ACACAATG
TACTATGG	TACATGGA
TACATGAA	TACATGGA
TACATGAT	TACATGGA
TACATGAG	TACATGGA
TACATGAN	TACATGGA
TACATGCA	TACATGGA
TAAATTAC	TAAATGAC
TACATGCG	TACATGGA
TCCCAGTG	TCCCATGC
TACATGTA	TACATGGA
TCCCAGGC	TCCCATGC
TACATGTG	TACATGGA
TACATGGA	TACATGGA
TACATGGC	TACATGGA
CNTAACAG	CCTAACAG
TACATGGT	TACATGGA
TACATGGG	TACATGGA
TACATGGN	TACATGGA
TACATGNA	TACATGGA
TAAATTGA	TAAATGAC
TACATGNG	TACATGGA
TAAATGAA	TAAATGAC
TGGTGATG	TGGTGAGG
TGGTGAGA	TGGTGAGG
TAATTGAC	TAAATGAC
TCCCANTG	TCCCATGC
TGGTGAGC	TGGTGAGG
TGGTGAGT	TGGTGAGG
TGGTGAGG	TGGTGAGG
TCCCANGC	TCCCATGC
CNGCACGA	CGCACGAC
TGGTGAGN	TGGTGAGG
TANAAAAT	TAAAAATC
TGGTGANG	TGGTGAGG
TAGAATGA	TAAATGAC
TGGTGCAG	TGGTGAGG
TANAAATC	TAAAAATC
TAAATGAC	TAAATGAC
TAAATGAG	TAAATGAC
TAGAAGAT	TAAAGATT
TAAATGAN	TAAATGAC
TAAATGCA	TAAATGAC
TAAATGCC	TAAATGAC
TAGAAGCA	TAGAGCAG
TAAATGCT	TAAATGAC
TAAATGCG	TAAATGAC
TAAATGCN	TAAATGAC
TAAATGTA	TAAATGAC
TAAATGTC	TAAATGAC
TCGTAGAA	CGTAGAAA
TAAATGGC	TAAATGAC
TAAATGNA	TAAATGAC
TAAATGNC	TAAATGAC
TACATNGA	TACATGGA
TACATNGG	TACATGGA
TCCCCATG	TCCCATGC
TACAGATT	TAAAGATT
TCGATGGC	TCGCTGGC
GACAACGG	GCAACGGC
TGCAAAAG	TTCAAAAG
GACAATAC	GCAATACT
TGGTGCGG	TGGTGAGG
GACAATAT	GATAATAT
TTAAGAAT	TTAAAATA
TCTCAAAA	TTCAAAAG
TGGTGTAG	TGGTGAGG
TCTCAAAG	TCTGAAAG
TAAATNAC	TAAATGAC
TTAAGATA	TTAAAATA
TTAAGATT	TAAAGATT
TCNGGAAC	TCTGGAAC
TCCGAAAG	TCTGAAAG
TCNGGACC	TCGGGACC
TCNGGACT	TCGGACTT
TAAATNGA	TAAATGAC
TACTCATC	ACTCATCC
TCGNACTT	TCGGACTT
TACTCAGT	AACTCAGT
TACAGCAG	TAGAGCAG
TCACATGC	TCCCATGC
TCACATGG	TACATGGA
TACAGCCG	ACAGCCGG
TGGTGTGG	TGGTGAGG
TACTCCCG	ACTCCCGA
TGGTGGAG	TGGTGAGG
TGCAACGG	GCAACGGC
TANGAGCA	TAGAGCAG
TGCAATAC	GCAATACT
TAAAGACA	TAAATGAC
TAAAGACC	TAAATGAC
TAAAGACG	TAAATGAC
TAAAGACN	TAAATGAC
TAAAGATA	TAAAGATT
TAAAGATT	TAAAGATT
TAAAGATG	TAAAGATT
TAAAGATN	TAAAGATT
TAATGACA	TAAATGAC
TCGAGACC	TCGGGACC
TAAAGAGT	TAAAGATT
TAATGACC	TAAATGAC
TAATGACT	TAAATGAC
TAATGACG	TAAATGAC
TAATGACN	TAAATGAC
TAAAGANT	TAAAGATT
TAATGATT	TAAAGATT
TCTCATCC	ACTCATCC
TANAATGA	TAAATGAC
TAAAGCAT	TAAAGATT
TAAAGCAG	TAGAGCAG
TCCCCTGC	TCCCATGC
TTCTAAAA	TTCAAAAG
TCTCATGC	TCCCATGC
TAAAGCTC	AAAGCTCG
TAAAGCTT	TAAAGATT
TTCTAAAG	TTCAAAAG
TACTCTCG	CACTCTCG
TANAAGAT	TAAAGATT
TACAGTGG	TACATGGA
TGGTGGGT	TGGTGAGG
TGGTGGGG	TGGTGAGG
TGGTGGGN	TGGTGAGG
TACAGGAA	TACATGGA
TACAGGAC	TACATGGA
TACAGGAT	TACATGGA
TACAGGAG	TACATGGA
TACAGGAN	TACATGGA
TGGTGNAG	TGGTGAGG
TACAGGGA	TACATGGA
TTCTACCC	TTTACCCT
TGGTGNGG	TGGTGAGG
GACACAAT	ACACAATG
TTCTACGA	GTTCTACG
TTCTACGC	GTTCTACG
TTCTACGT	GTTCTACG
TTCTACGG	GTTCTACG
TTCTACGN	GTTCTACG
TCGTCCGG	CGTCCGGG
TTAAGTAA	TTAGTAAC
TAGACAGA	TAGAGCAG
TAGACAGC	TAGAGCAG
TAGACAGT	TAGAGCAG
TAGACAGG	TAGAGCAG
TAGACAGN	TAGAGCAG
TCGAGCAG	TAGAGCAG
TCCCCGGC	CCCCGGCA
TAAAGTAT	TAAAGATT
TAGACCAG	TAGAGCAG
TACTCGTA	CTACTCGT
TACTCGTC	CTACTCGT
TACAGGGG	TAAGGGGC
TACTCGTT	CTACTCGT
TAGACCCT	TGACCCTT
TACTCGTG	CTACTCGT
TACTCGTN	CTACTCGT
TAAAGTTA	TAAAGATT
TAAAGTTC	TAAAGATT
TAAAGTTT	TAAAGATT
TAAAGTTG	TAAAGATT
TGCACCCT	TGACCCTT
TAAAGTTN	TAAAGATT
TCGTCTGG	TCGCTGGC
TAAAGTGA	TAAATGAC
TCCGATGC	TCCCATGC
GACCACCT	GTCCACCT
TTTATCCC	TTTACCCT
TAAAGGAC	TAAATGAC
TTTATCCT	TTTACCCT
TAAAGGAT	TAAAGATT
TGGTNAGG	TGGTGAGG
TAAAGGTT	TAAAGATT
TTNGTAAC	TTAGTAAC
TAAAGGGC	TAAGGGGC
TCACCATG	TCCCATGC
TCTTCCAT	ACTTCCAT
TAAAGGGG	TAAGGGGC
GACCACTC	GACCCTCA
TAAAGNAT	TAAAGATT
TGAAAAAT	TAAAAATC
TTGGTAAC	TTAGTAAC
TGAAAACC	TGATAACC
TGCACGAC	CGCACGAC
TGAAAATA	TTAAAATA
TGAAAATC	TAAAAATC
TAAAGNTT	TAAAGATT
TAATGTCG	AATGTCGT
TACNATGG	TACATGGA
TATCGGTC	CATCGGTC
TAAANAAT	TAAAAATC
TAGACTAA	TGAGACTA
TAGACTAC	TGAGACTA
TAGACTAT	TGAGACTA
TCCCTATG	TCCCATGC
GAATGCAT	GAACGCAT
TAGACTAG	TGAGACTA
TAGACTAN	TGAGACTA
TTAAGGGG	TAAGGGGC
TAAANATC	TAAAAATC
TAAANATT	TAAAGATT
GACCATCA	GACCCTCA
GAATGCTA	GAAGCTAG
TCNGGGAC	TCGGGACC
TTNAAAAT	TTAAAATA
TAATGTTG	AATGTTGT
TTNAAAAG	TTCAAAAG
TCACCCTT	TGACCCTT
TTNAAATA	TTAAAATA
TAATGGAA	TACATGGA
TAATGGAC	TACATGGA
TAATGGAT	TACATGGA
TAATGGAG	TACATGGA
TAATGGAN	TACATGGA
TAATGGGC	TAAGGGGC
CNGCCCAT	CGGCCCAT
TAATGGGG	TAAGGGGC
TGAAACCA	TGATAACC
TGAAACCC	TGATAACC
TCTCCATG	TCCCATGC
TGAAACCT	TGATAACC
TGAAACCG	TGATAACC
TGAAACCN	TGATAACC
TGAAACTA	TGAGACTA
GACACCTC	GACCCTCA
TAAANTGA	TAAATGAC
TACTTCCA	ACTTCCAT
GAATGTCG	AATGTCGT
TTCNAAAA	TTCAAAAG
TCGAGGAC	TCGGGACC
TTCNAAAG	TTCAAAAG
GAATGTTG	AATGTTGT
TAAANGAC	TAAATGAC
TAAANGAT	TAAAGATT
GACACTCA	GACCCTCA
TAGACGCA	TAGAGCAG
TTTTGGCT	CTTTGGCT
TCCCTTGC	TCCCATGC
GACTTCCA	ACTTCCAT
TTTTGGGC	TTGTGGGC
TGCATAAC	TGATAACC
TGCATAGA	GGCATAGA
TNTAAAAT	TTAAAATA
TCTCCCGA	ACTCCCGA
TATAAATC	TAAAAATC
TCCCTGCA	TCCCATGC
TCCCTGCC	TCCCATGC
TCCCTGCT	TCCCATGC
TCCCTGCG	TCCCATGC
TCCCTGCN	TCCCATGC
TCCCTGGC	TCGCTGGC
GACCCACA	GACCCTCA
TATAACCA	TGATAACC
TATAACCC	TGATAACC
GAACACAT	GAACGCAT
TGAAATGA	TAAATGAC
TATAACCT	TGATAACC
TGAAATGC	AGAAATGC
TATAACCG	TGATAACC
TATAACCN	TGATAACC
TGGTNGAG	TGGTGAGG
GACTTTAC	GCCTTTAC
TCGNCTGG	TCGCTGGC
GACACGCA	GAACGCAT
GACTTTTT	GCTTTTTA
TACANTGG	TACATGGA
TGCATCAA	TGGATCAA
TGAGAACC	TGATAACC
TGAGAACT	TGAGACTA
TGAGAATA	TGAGACTA
TGAAAGAT	TAAAGATT
GACCCATC	GACCCTCA
CNCCGGCA	CCCCGGCA
TACTTGGA	TACATGGA
TAACAAAT	TAAAAATC
GAACAGCA	GAACGCAT
TAACAATC	TAAAAATC
TTGGTGAG	TGGTGAGG
GACCCCAA	GACCCTCA
GACCCCAC	GACCCTCA
GACCCCAT	GACCCTCA
TTNGTGGG	TTGTGGGC
GACTTTGG	GTCTTTGG
TATAATAT	GATAATAT
TTGGTGGG	TTGTGGGC
TAGATAAC	TGATAACC
TGGNTCAA	TGGATCAA
TACANGGA	TACATGGA
TCGTTGGC	TCGCTGGC
GACCCCAG	GACCCTCA
TGAGACAA	TGAGACTA
GACATAGA	GGCATAGA
GACCCCAN	GACCCTCA
TGAGACAC	TGAGACTA
GAACCATA	GAACGCAT
GACCCCCA	GACCCTCA
TGAGACAT	TGAGACTA
GAACCATC	GAACGCAT
TGAGACAG	TGAGACTA
GAACCATT	GAACGCAT
TGAGACAN	TGAGACTA
GAACCATG	GAACGCAT
TGAGACCA	TGAGACTA
GAACCATN	GAACGCAT
TGAGACCT	TGAGACTA
GACCCCTC	GACCCTCA
TGAGACTA	TGAGACTA
TGAGACTC	TGAGACTA
TGAGACTT	TGAGACTA
TGAGACTG	TGAGACTA
TGAGACTN	TGAGACTA
TGAGACGA	TGAGACTA
TGAGACGT	TGAGACTA
GAACCCAT	GAACGCAT
TGAGACNA	TGAGACTA
GACCCTAA	GACCCTCA
TGAGACNT	TGAGACTA
GACCCTAC	GACCCTCA
GAACCCTC	GACCCTCA
TATAATGA	TAAATGAC
TATAAGAA	AATAAGAA
GAACCTAA	CAACCTAA
TATAAGAT	TAAAGATT
GAACCTAG	GAAGCTAG
TCACTCTC	CACTCTCG
TTNACCCT	TTTACCCT
GAACCTCA	GACCCTCA
TAGATCAA	TGGATCAA
TAGATCAG	TAGAGCAG
TCGTGAAA	TCTGAAAG
TGCATGGA	TACATGGA
TCGTGACC	TCGGGACC
TCGTGACT	TCGGACTT
GACCCTAT	GACCCTCA
GACCCTAG	GACCCTCA
GACCCTAN	GACCCTCA
GACCCTCA	GACCCTCA
GAACCGCA	GAACGCAT
GACCCTCC	GACCCTCA
GACCCTCT	GACCCTCA
TTTAGCCC	TTTACCCT
GACCCTCG	GACCCTCA
TTTAGCCT	TTTACCCT
GACCCTCN	GACCCTCA
GACCCTTT	TGACCCTT
GACCCTTG	TGACCCTT
GACCCTTN	TGACCCTT
GACCCTGA	GACCCTCA
GACCCTGC	GACCCTCA
TGGAACAA	TGGATCAA
GACCCTNA	GACCCTCA
GACCCTNC	GACCCTCA
TTGGGACC	TCGGGACC
TAACATGA	TAAATGAC
TAACATGG	TACATGGA
TATTACAG	ATTACAGG
TATTACCC	TTTACCCT
TGAGATAA	TGAGACTA
TGAGATAC	TGAGACTA
TGAGATAT	TGAGACTA
TGAGATAG	TGAGACTA
TGAACCCT	TGACCCTT
TGAGATAN	TGAGACTA
TGAGATCA	TGGATCAA
TGGGACCA	TCGGGACC
TCGTGAGG	TGGTGAGG
TGGGACCC	TCGGGACC
TGAGATCT	TGAGACTA
TGGGACCT	TCGGGACC
TGAACCTT	TGACCCTT
TGAGATTA	TGAGACTA
TGGNTGAG	TGGTGAGG
TGCCCATG	TCCCATGC
GACATTGG	GATATTGG
TCTTTTTA	GCTTTTTA
TTTAGTAA	TTAGTAAC
TGCAGACT	TGAGACTA
GACATGGA	TACATGGA
TGGAATCA	TGGATCAA
TAACAGAT	TAAAGATT
GACCCGCA	GACCCTCA
GACTGAGG	ACTGAGGA
TNCAAAAG	TTCAAAAG
TGGGACCG	TCGGGACC
GACCCGTC	GACCCTCA
TGGGACCN	TCGGGACC
TGGGACTA	TGAGACTA
TGGGACTT	TCGGACTT
TGCCCCTT	TGACCCTT
TATTATGT	AATTATGT
TGAACTAA	TGAGACTA
TGAACTAC	TGAGACTA
TGAACTAT	TGAGACTA
TGAACTAG	TGAGACTA
TGAACTAN	TGAGACTA
TGGGATAC	GGGATACA
GACCCNCA	GACCCTCA
TNGACCCT	TGACCCTT
TTGTAACA	TTAGTAAC
TGAGAGCA	TAGAGCAG
TGGGATCA	TGGATCAA
TTGTAACC	TTAGTAAC
TGGGATCC	GGGGATCC
TTGTAACT	TTAGTAAC
TGAGAGCT	TGAGACTA
TTGTAACG	TTAGTAAC
TTGTAACN	TTAGTAAC
GACCCNTC	GACCCTCA
TGAGAGTA	TGAGACTA
TTTGAAAG	TCTGAAAG
TCTTTGGA	GTCTTTGG
TCACTGTT	CACTGTTT
GAACTAGA	GAAGCTAG
GAACTAGC	GAAGCTAG
TCTTTGGT	GTCTTTGG
GAACTAGT	GAAGCTAG
TCTTTGGG	GTCTTTGG
GAACTAGG	GAAGCTAG
TCTTTGGN	GTCTTTGG
TCACTGGC	TCGCTGGC
TAGATGAC	TAAATGAC
GAACTAGN	GAAGCTAG
TAGATGCA	TAGAGCAG
TTGTACCC	TTTACCCT
GAACTCAT	GAACGCAT
TGNAGACT	TGAGACTA
GAACTCAG	AACTCAGT
TAGATGGA	TACATGGA
TTTGGAAC	TCTGGAAC
TCGTGGAA	TCTGGAAC
TCGTGGAC	TCGGGACC
GACTGTTT	CACTGTTT
TCGTGGCA	TCGCTGGC
TCGTGGCC	TCGCTGGC
TGCCCTTA	TGACCCTT
TCGTGGCT	TCGCTGGC
TGCCCTTC	TGACCCTT
TTGGGGCA	TTGTGGGC
TCGTGGCG	TCGCTGGC
TGCCCTTT	TGACCCTT
TTGGGGCC	TTGTGGGC
TCGTGGCN	TCGCTGGC
TGCCCTTG	TGACCCTT
TTGGGGCT	TTGTGGGC
TGCCCTTN	TGACCCTT
TTGGGGCG	TTGTGGGC
TTGGGGCN	TTGTGGGC
TGACTAAC	TGATAACC
TGAACGCA	GAACGCAT
TCGTGGGC	TTGTGGGC
TTGGGGGC	TTGTGGGC
TGAGANCT	TGAGACTA
TGAGANTA	TGAGACTA
TTTGACCC	TTTACCCT
TTGTAGGC	TTGTGGGC
TGACTCCT	TGACCCTT
TTGTAGGG	TTGTGGGC
TGACTCTT	TGACCCTT
TATACCCT	TTTACCCT
TCGCACTT	TCGGACTT
TCGCACGA	CGCACGAC
TCTTGAAA	TCTGAAAG
TGGACAAA	TGGATCAA
TGGNGAGG	TGGTGAGG
TCTTGAAC	TCTGGAAC
TGGACAAC	TGGATCAA
TGGACAAT	TGGATCAA
TGCCCGCG	AGCCCGCG
TGGACAAG	TGGATCAA
TGGACAAN	TGGATCAA
GACCTCAA	GACCCTCA
GACCTCAC	GACCCTCA
GACCTCAT	GACCCTCA
GACCTCAG	GACCCTCA
GAACTGCA	GAACGCAT
TCGCATGC	TCCCATGC
TTTGGCTA	CTTTGGCT
TNCGGACT	TCGGACTT
GACCTCAN	GACCCTCA
TGAGCACT	TGAGACTA
GACCTCTC	GACCCTCA
TGAATAAC	TGATAACC
TGGGAGGA	TGGTGAGG
TGGGAGGC	TGGTGAGG
TGGGAGGT	TGGTGAGG
TGGGAGGG	TGGTGAGG
TGAGCAGA	TAGAGCAG
TGGGAGGN	TGGTGAGG
TGAGCAGC	TAGAGCAG
TGAGCAGT	TAGAGCAG
TGAGCAGG	TAGAGCAG
TGAGCAGN	TAGAGCAG
TNTACCCT	TTTACCCT
GACCTTCA	GACCCTCA
TCGCATGG	TCGCTGGC
TGAGCCCT	TGACCCTT
GACCTTTA	GCCTTTAC
TGAATCAA	TGGATCAA
TGAGCCTA	TGAGACTA
TTTGGCTC	CTTTGGCT
TTTGGCTT	CTTTGGCT
GAAGACTA	GAAGCTAG
TTTGGCTG	CTTTGGCT
TTTGGCTN	CTTTGGCT
GACAGCCG	ACAGCCGG
TNGATAAC	TGATAACC
GACAGCTA	GAAGCTAG
TTTANCCC	TTTACCCT
TTTANCCT	TTTACCCT
GAAGATAG	GAAGCTAG
GAACGAAT	GAACGCAT
TNGGACTT	TCGGACTT
TGGACCAA	TGGATCAA
GAACGACA	GAACGCAT
GAACGATA	GAACGCAT
TGAGCCTT	TGACCCTT
GAACGATC	GAACGCAT
GAACGATT	GAACGCAT
GAACGATG	GAACGCAT
GAACGATN	GAACGCAT
GACCTTGG	ACCTTGGT
TCGCAGGC	TCGCTGGC
TNGGATCA	TGGATCAA
TGAGCTAA	TGAGACTA
TGAGCTAC	TGAGACTA
TGAGCTAT	TGAGACTA
TGGANCAA	TGGATCAA
TGAGCTAG	TGAGACTA
TGAGCTAN	TGAGACTA
TNGATCAA	TGGATCAA
TGGACCCT	TGACCCTT
TATTCCTC	ATTCCTCC
GTCATAGA	GGCATAGA
TGNTGAGG	TGGTGAGG
TGGANTCA	TGGATCAA
TGAATGAC	TAAATGAC
TCTTGGAA	TCTGGAAC
TGAGCGCG	AGAGCGCG
TNCGGGAC	TCGGGACC
GAACGCAA	GAACGCAT
GAACGCAC	GAACGCAT
GAACGCAT	GAACGCAT
GAACGCAG	GAACGCAT
TTTGGGCA	TTGTGGGC
GAACGCAN	GAACGCAT
TTTGGGCC	TTGTGGGC
GAACGCCA	GAACGCAT
TTTGGGCT	TTGTGGGC
TTTGGGCG	TTGTGGGC
GAACGCCT	GAACGCAT
TTTGGGCN	TTGTGGGC
TGGACTAA	TGAGACTA
TGGACTAC	TGAGACTA
GAACGCTC	GAACGCAT
TGGACTAT	TGAGACTA
GAACGCTT	GAACGCAT
TGGACTAG	TGAGACTA
GAACGCTG	GAACGCAT
TGGACTAN	TGAGACTA
GAACGCTN	GAACGCAT
TGGACTCA	TGGATCAA
GAACGCGA	GAACGCAT
GAACGCGT	GAACGCAT
TGCCTTTA	GCCTTTAC
TGGACTTA	TCGGACTT
TGGACTTC	TCGGACTT
TGGACTTT	TCGGACTT
TGGACTTG	TCGGACTT
TGGACTTN	TCGGACTT
TTTGCCCT	TTTACCCT
TGCGACTA	TGAGACTA
GAAGCAAG	GAAGCTAG
GAAGCACC	AAGCACCC
GAAGCATC	GAACGCAT
GAAGCATT	GAACGCAT
GAAGCATG	GAACGCAT
GAAGCATN	GAACGCAT
TNATAACC	TGATAACC
TGCGATCC	GTGCGATC
TGCGATCT	GTGCGATC
TGCGATCG	GTGCGATC
GAACGCNA	GAACGCAT
GAACGCNT	GAACGCAT
GAACGTAT	GAACGCAT
GAACGTCA	GAACGCAT
GTCATTTG	GTCTTTGG
GTCATTGG	GTCTTTGG
GAACGTTT	AACGTTTA
TTGTCGGC	TTGTGGGC
TTGTCGGG	TTGTGGGC
GAACGGAT	GAACGCAT
TGCGATCN	GTGCGATC
TTTCAAAA	TTCAAAAG
GACCGCAT	GAACGCAT
GAAGCAGA	GAAGCTAG
TTCTTTGG	GTCTTTGG
GAAGCAGC	GAAGCTAG
GAAGCAGT	GAAGCTAG
GAAGCAGG	GAAGCTAG
GACCGCTC	GACCCTCA
GAAGCAGN	GAAGCTAG
TGCGAGAC	GGCGAGAC
TGAGTACT	TGAGACTA
GAACGGCC	GCAACGGC
GAACGGCT	GCAACGGC
GAACGGCG	GCAACGGC
GAAGCCAG	GAAGCTAG
GAACGGCN	GCAACGGC
TNGCTGGC	TCGCTGGC
GAAGCCTA	GAAGCTAG
GAACGNAT	GAACGCAT
GAACGNCA	GAACGCAT
GACCGTCA	GACCCTCA
TGAAGACT	TGAGACTA
TGAAGATT	TAAAGATT
TGACGACT	TGAGACTA
GAAGCTAA	GAAGCTAG
GAAGCTAC	GAAGCTAG
GAAGCTAT	GAAGCTAG
TGAAGCTA	GAAGCTAG
GAAGCTAG	GAAGCTAG
GAAGCTAN	GAAGCTAG
GAAGCTCA	GAAGCTAG
TTTGTAAC	TTAGTAAC
GAAGCTTA	GAAGCTAG
GAAGCTTG	GAAGCTAG
GAAGCTGA	GAAGCTAG
GAAGCTGC	GAAGCTAG
TNGAGACT	TGAGACTA
TGTTGAGG	TGGTGAGG
TNGAGCAG	TAGAGCAG
TTTCACCC	TTTACCCT
GAAGCTGT	GAAGCTAG
GAAGCTGG	GAAGCTAG
GAAGCTGN	GAAGCTAG
GAAGCTNA	GAAGCTAG
GAACNCAT	GAACGCAT
GAAGCTNG	GAAGCTAG
GAAGCGAG	GAAGCTAG
GAAGCGCA	GAACGCAT
TGTTGCCT	AGTTGCCT
GAAGCGTA	GAAGCTAG
TATATTGG	GATATTGG
TTNTACCC	TTTACCCT
TGGCATAG	GGCATAGA
TGACGCCT	TGACCCTT
TGGCATCA	TGGATCAA
TGGATAAA	TGGATCAA
TGAGTCTA	TGAGACTA
TGACGCTT	TGACCCTT
TGGATAAT	TGGATCAA
TGGATAAG	TGGATCAA
TGGATAAN	TGGATCAA
TATATGAC	TAAATGAC
TGCCGTTC	AGCCGTTC
TTCTGAAA	TCTGAAAG
TATATGGA	TACATGGA
TNCATGGA	TACATGGA
TGAAGGGG	TAAGGGGC
TTNAGTAA	TTAGTAAC
GTCAGTTA	AGTCAGTT
GTCAGTTC	AGTCAGTT
GTCAGTTT	AGTCAGTT
GTCAGTTG	AGTCAGTT
GTCAGTTN	AGTCAGTT
GAAGCNAG	GAAGCTAG
TGGGTCAA	TGGATCAA
TGGATCAA	TGGATCAA
TGGATCAC	TGGATCAA
TGGATCAT	TGGATCAA
GAAGCNTA	GAAGCTAG
TGGGTCTG	GGGTCTGC
TGGGTCGT	GGGTCGTA
TCAAAAAT	TAAAAATC
GGCCACCT	GTCCACCT
TGGCCAAA	CTGGCCAA
TGGCCAAC	CTGGCCAA
TGAGTGAG	TGGTGAGG
TGGCCAAT	CTGGCCAA
TGGCCAAG	CTGGCCAA
TGGCCAAN	CTGGCCAA
GAACNGCA	GAACGCAT
TCAAAATA	TTAAAATA
TCAAAATC	TAAAAATC
GACGAAGG	ACGAAGGG
TCAAAAGA	TTCAAAAG
GACCNCTC	GACCCTCA
TCAAAAGC	TTCAAAAG
TCAAAAGT	TTCAAAAG
TCAAAAGG	TTCAAAAG
TCAAAAGN	TTCAAAAG
TGGATCAG	TGGATCAA
TGGATCAN	TGGATCAA
TGGATCCA	TGGATCAA
TGGCCCAT	CGGCCCAT
TGGGTGAG	TGGTGAGG
TTTGTGGG	TTGTGGGC
TGGCCCTT	TGACCCTT
TGGATCTA	TGGATCAA
GAAGTAGA	GAAGCTAG
TGGATCGA	TGGATCAA
GAAGTAGC	GAAGCTAG
GAAGTAGT	GAAGCTAG
GAAGTAGG	GAAGCTAG
GAAGTAGN	GAAGCTAG
TGGATCNA	TGGATCAA
TTGTTGGC	TTGTGGGC
TTGTTGGG	TTGTGGGC
TGGATTAA	TGGATCAA
TGCGCTGG	TCGCTGGC
GGCCATAG	GGCATAGA
GAAGTCTA	GAAGCTAG
TATAGATT	TAAAGATT
TGTAAAAT	TTAAAATA
TGGGGACC	TCGGGACC
GACCNTCA	GACCCTCA
TATAGCAG	TAGAGCAG
TGGGGATC	GGGGATCC
TTCTGGAA	TCTGGAAC
TNGGTGAG	TGGTGAGG
TGGGGAGG	TGGTGAGG
GAATAATA	GATAATAT
TNCTGAAA	TCTGAAAG
TGGATTCA	TGGATCAA
TTTCCCCT	TTTACCCT
GAAGTTAG	GAAGCTAG
TTTCCCTA	TTTACCCT
TTTCCCTC	TTTACCCT
TTTCCCTT	TTTACCCT
TTTCCCTG	TTTACCCT
TCAAATGA	TAAATGAC
TTTCCCTN	TTTACCCT
GAATAAGA	AATAAGAA
TCAAAGAT	TAAAGATT
TGTAACCA	TGATAACC
TTGTGAGC	TTGTGGGC
TGTAACCC	TGATAACC
TGTAACCT	TGATAACC
TTCTGGGC	TTGTGGGC
TGTAACCG	TGATAACC
TNTTACCC	TTTACCCT
TGGCTAGT	GGCTAGTT
TGTAACCN	TGATAACC
TCAAAGTC	CCAAAGTC
GGCCAGAC	GGCGAGAC
TGGCTCAA	TGGATCAA
TGCCATGC	TCCCATGC
GAATACTA	GCAATACT
GGCCAGTT	GGCTAGTT
GAATACTC	GCAATACT
GAATACTT	GCAATACT
TATAGTAA	TTAGTAAC
GAATACTG	GCAATACT
GAATACTN	GCAATACT
TTTNACCC	TTTACCCT
TTTCCTCC	ATTCCTCC
TGGCTTCA	GTGGCTTC
TGGCTTCC	GTGGCTTC
TGGCTTCT	GTGGCTTC
TGGCTTCG	GTGGCTTC
TTGATAAC	TGATAACC
TGGCTTCN	GTGGCTTC
TGAGGACT	TGAGACTA
TTGTGCCA	CTGTGCCA
TTGTGCGC	TTGTGGGC
TTGTGCGG	TTGTGGGC
TGGATGAA	TGGATCAA
TGGCTGAG	TGGTGAGG
TGGATGAG	TGGTGAGG
TTGATCAA	TGGATCAA
TGGATGCA	TGGATCAA
TNTAGTAA	TTAGTAAC
TGNGACTA	TGAGACTA
TNGGGACC	TCGGGACC
GACGAGAC	GGCGAGAC
TGGCTGGC	TCGCTGGC
TGACNCCT	TGACCCTT
GAATATTG	GATATTGG
TNCTGGAA	TCTGGAAC
TGCGTATC	AGCGTATC
TTGTGTGC	TTGTGGGC
TTGTGTGG	TTGTGGGC
TGAGGCTA	TGAGACTA
TGGCGAGA	GGCGAGAC
TTGTGGAC	TTGTGGGC
TGGCGAGG	TGGTGAGG
TTGTGGAG	TTGTGGGC
TTGTGGCA	TTGTGGGC
TTGTGGCC	TTGTGGGC
TTGTGGCT	TTGTGGGC
TTGTGGCG	TTGTGGGC
TGACNCTT	TGACCCTT
TTGATGGG	TTGTGGGC
TTGTGGCN	TTGTGGGC
TTGTGGTC	TTGTGGGC
TTGTGGTG	TTGTGGGC
TGGATNAA	TGGATCAA
TGNACCCT	TGACCCTT
TTGTGGGA	TTGTGGGC
TTGTGGGC	TTGTGGGC
TGGATNCA	TGGATCAA
TGNGATCA	TGGATCAA
GACTAAAC	ACTAAACG
GACTAATA	GATAATAT
TATAGGGG	TAAGGGGC
GGCCCATA	CGGCCCAT
GGCCCATC	CGGCCCAT
GGCCCATT	CGGCCCAT
GGCCCATG	CGGCCCAT
GGCCCATN	CGGCCCAT
TTGAGACT	TGAGACTA
TTGTGGGT	TTGTGGGC
TTGTGGGG	TTGTGGGC
TTGTGGGN	TTGTGGGC
TTGTGGNC	TTGTGGGC
GAAGGCAT	GAACGCAT
TTGTGGNG	TTGTGGGC
GAAGGCTA	GAAGCTAG
TTTCTACG	GTTCTACG
TTGTGNGC	TTGTGGGC
TTGTGNGG	TTGTGGGC
GAAGGTAG	GAAGCTAG
TGGAGACT	TGAGACTA
TTTAAAAT	TTAAAATA
GTCCAACC	GTCCACCT
TTTAAAAG	TTCAAAAG
GTCCAACT	GTCCACCT
TTGAGCAG	TAGAGCAG
TTTAAATA	TTAAAATA
TGGAGAGG	TGGTGAGG
TGCGTGAG	TGGTGAGG
TGGAGCAA	TGGATCAA
GTCCACAC	GTCCACCT
TGGAGCAG	TAGAGCAG
GCCCTCAA	GACCCTCA
GTCCACAT	GTCCACCT
GCCCTCAC	GACCCTCA
TGTCAAAA	TTCAAAAG
TTGAGTAA	TTAGTAAC
GAATCTAG	GAAGCTAG
TGTGAAAG	TCTGAAAG
GACGCATA	GAACGCAT
GCCCTCAT	GACCCTCA
GACGCATC	GAACGCAT
GCCCTCAG	GACCCTCA
GACGCATT	GAACGCAT
GCCCTCAN	GACCCTCA
GACGCATG	GAACGCAT
TGAGGGGC	TAAGGGGC
GACGCATN	GAACGCAT
GACTATTG	GATATTGG
GTCCACCA	GTCCACCT
GTCCACCC	GTCCACCT
GTCCACCT	GTCCACCT
GTCCACCG	GTCCACCT
GAATCGCA	GAACGCAT
GTCCACCN	GTCCACCT
GTCCACTA	GTCCACCT
GTCCACTC	GTCCACCT
GTCCACTT	GTCCACCT
GTCCACTG	GTCCACCT
GTCCACTN	GTCCACCT
GATNAATA	GATAATAT
GTCCACGC	GTCCACCT
GTCCACGT	GTCCACCT
GTCCACNC	GTCCACCT
GTCCACNT	GTCCACCT
TTTNCCCT	TTTACCCT
TGACAACC	TGATAACC
TTTAACCC	TTTACCCT
TTTAACCT	TTTACCCT
GTCCATCC	GTCCACCT
GGCCCTCA	GACCCTCA
GTCCATCT	GTCCACCT
TNAATGAC	TAAATGAC
TGCTAACC	TGATAACC
GCCCTTAC	GCCTTTAC
TGATAAAC	TGATAACC
TGATAACA	TGATAACC
TGATAACC	TGATAACC
TGCGGACT	TCGGACTT
TGACACCT	TGACCCTT
TGACACTA	TGAGACTA
TGACACTT	TGACCCTT
GACTAGTT	GGCTAGTT
TTGAGGGC	TTGTGGGC
TTNCAAAA	TTCAAAAG
TGGAGTCA	TGGATCAA
TGAGNACT	TGAGACTA
GAATTATG	AATTATGT
GAAAAATC	TAAAAATC
GCCCTTTA	GCCTTTAC
GTCCAGCC	GTCCACCT
GTCCAGCT	GTCCACCT
TGAGNCTA	TGAGACTA
GAAGGGGC	TAAGGGGC
GACTCATC	ACTCATCC
TGATAACT	TGATAACC
TGATAACG	TGATAACC
TGATAACN	TGATAACC
TGATAATA	GATAATAT
TGATAATC	TGATAACC
TGATAAGC	TGATAACC
GGCCCGCG	AGCCCGCG
TGATAANC	TGATAACC
TGATACAC	TGATAACC
TNAAGATT	TAAAGATT
GTCCANCC	GTCCACCT
GTCCANCT	GTCCACCT
TGATACCA	TGATAACC
TGATACCC	TGATAACC
TGATACCT	TGATAACC
TGATACCG	TGATAACC
GACTCAGT	AACTCAGT
TGATACCN	TGATAACC
TGATACTA	TGAGACTA
GACGCCTC	GACCCTCA
TGNCCCTT	TGACCCTT
GACTCCCG	ACTCCCGA
TGATATAC	TGATAACC
GACTCCTC	GACCCTCA
GACGCTAG	GAAGCTAG
GTCCCACC	GTCCACCT
TGACATGG	TACATGGA
TGNATAAC	TGATAACC
GTCCCATG	TCCCATGC
GACGCTCA	GACCCTCA
GAAAATAT	GATAATAT
TGTGACTA	TGAGACTA
TGTGATCA	TGGATCAA
TTCGAAAA	TTCAAAAG
GACTCTCA	GACCCTCA
TTCGAAAG	TTCAAAAG
GACTCTCG	CACTCTCG
TTGTNGGC	TTGTGGGC
TTGTNGGG	TTGTGGGC
GTCCCCCT	GTCCACCT
GTCCCCTA	GTCCACCT
GTCCCCTC	GTCCACCT
GTCCCCTT	GTCCACCT
GTCCCCTG	GTCCACCT
GTCCCCTN	GTCCACCT
TGCGGGAC	TCGGGACC
TGNATCAA	TGGATCAA
TTNTGGGC	TTGTGGGC
TTTACACC	TTTACCCT
TTTACACT	TTTACCCT
GATNATAT	GATAATAT
TGATATCC	TGATAACC
TGTCAGTT	AGTCAGTT
TTTACAGG	ATTACAGG
GAATTTTA	AATTTTAC
TGATATTG	GATATTGG
GATNATTG	GATATTGG
TGTGAGGA	TGGTGAGG
TTGNTGGG	TTGTGGGC
TGTGAGGC	TGGTGAGG
GTCCCTCA	GACCCTCA
TGTGAGGT	TGGTGAGG
TGATAGAC	TGATAACC
TGCGGGTG	GCGGGTGA
GAAGNCTA	GAAGCTAG
TTTACCAC	TTTACCCT
TTTACCAT	TTTACCCT
TGTGAGGG	TGGTGAGG
TTTACCCA	TTTACCCT
TGTGAGGN	TGGTGAGG
TTTACCCC	TTTACCCT
TTTACCCT	TTTACCCT
TTTACCCG	TTTACCCT
TNTCAAAA	TTCAAAAG
TTTACCCN	TTTACCCT
TTTACCTA	TTTACCCT
TTTACCTC	TTTACCCT
TTTACCTT	TTTACCCT
TTTACCTG	TTTACCCT
TTTACCTN	TTTACCCT
TTTACCGC	TTTACCCT
TTTACCGT	TTTACCCT
GCCCGCGA	AGCCCGCG
GCCCGCGC	AGCCCGCG
GCCCGCGT	AGCCCGCG
GCCCGCGG	AGCCCGCG
TTTACCNC	TTTACCCT
TGCTAGTT	GGCTAGTT
GCCCGCGN	AGCCCGCG
TTTACCNT	TTTACCCT
TGATAGCC	TGATAACC
TTGGAACA	TCTGGAAC
TTGGAACC	TCTGGAAC
GGCCTAGA	GGCATAGA
GAATTGGA	GATATTGG
TTGGAACT	TCTGGAAC
GAATTGGC	GATATTGG
TTGGAACG	TCTGGAAC
GGCCTAGT	GGCTAGTT
GAATTGGT	GATATTGG
TTGGAACN	TCTGGAAC
GAATTGGG	GATATTGG
GAATTGGN	GATATTGG
TGGTAACC	TGATAACC
TNAAGGGG	TAAGGGGC
TGATANAC	TGATAACC
TGACCACT	TGACCCTT
GGCTGAGA	GGCGAGAC
TNTGTGGG	TTGTGGGC
GGCTGAGT	GGCTAGTT
TGACCATT	TGACCCTT
TTTACTCC	TTTACCCT
TTTACTCT	TTTACCCT
TTGGACTT	TCGGACTT
GAAGNTAG	GAAGCTAG
TNTGGAAC	TCTGGAAC
TTTACGCC	TTTACCCT
TTTACGCT	TTTACCCT
TGANAACC	TGATAACC
TGTGCCAA	CTGTGCCA
TGGTAAGG	TGGTGAGG
TGTGCCAC	CTGTGCCA
TGTGCCAT	CTGTGCCA
TGTGCCAG	CTGTGCCA
TGTGCCAN	CTGTGCCA
TGATANCC	TGATAACC
GTCCTACC	GTCCACCT
GTCCTACG	GTTCTACG
TTGGATCA	TGGATCAA
TTTACNCC	TTTACCCT
TTTACNCT	TTTACCCT
TGACCCAT	TGACCCTT
TGATCAAA	TGGATCAA
TGATCAAT	TGGATCAA
TGATCAAG	TGGATCAA
GCGCACGA	CGCACGAC
TGTCCACC	GTCCACCT
TGATCAAN	TGGATCAA
TGACCCCT	TGACCCTT
GAAACTAG	GAAGCTAG
TGACCCTA	TGACCCTT
GCCCGGCA	CCCCGGCA
GGCTGTTA	GGCTAGTT
GGCTGTTC	GGCTAGTT
TGACCCTT	TGACCCTT
GGCTGTTT	GGCTAGTT
TGACCCTG	TGACCCTT
GGCTGTTG	GGCTAGTT
TGACCCTN	TGACCCTT
GGCTGTTN	GGCTAGTT
TGACCCGT	TGACCCTT
GCGCATAG	GGCATAGA
TGACCCNT	TGACCCTT
TGTATCAA	TGGATCAA
TGGTATAA	GGTATAAC
TGGTATCA	TGGATCAA
GTCCTCCT	GTCCACCT
TGANACTA	TGAGACTA
TGATCACC	TGATAACC
GATAGATA	GATAATAT
TGGTAGAG	TGGTGAGG
GAAACGCA	GAACGCAT
GGCTGGTT	GGCTAGTT
GGCTGGGA	GGTGGGAA
GAAACGGC	GCAACGGC
TGACCTCT	TGACCCTT
TGACCTTA	TGACCCTT
TGNGTGAG	TGGTGAGG
TGACCTTC	TGACCCTT
TGTCCCTT	TGACCCTT
TGACCTTT	TGACCCTT
TGACCTTG	TGACCCTT
TGACCTTN	TGACCCTT
TGTGCGAT	GTGCGATC
GGCCTTTA	GCCTTTAC
TNAAAAAT	TAAAAATC
GTGCGAAC	GTGCGATC
GTGCGAAT	GTGCGATC
GTGCGACA	GTGCGATC
GTGCGACC	GTGCGATC
GTGCGACT	GTGCGATC
TNAAAATA	TTAAAATA
GTGCGACG	GTGCGATC
TNAAAATC	TAAAAATC
GTGCGACN	GTGCGATC
GTCCTTTA	GCCTTTAC
GTGCGATA	GTGCGATC
TGGTAGGA	TGGTGAGG
GTGCGATC	GTGCGATC
TGGTAGGC	TGGTGAGG
GTGCGATT	GTGCGATC
TGGTAGGT	TGGTGAGG
GTCCTTTG	GTCTTTGG
GTGCGATG	GTGCGATC
TGGTAGGG	TGGTGAGG
GTGCGATN	GTGCGATC
TGGTAGGN	TGGTGAGG
GTGCGAGA	GGCGAGAC
GTGCGAGC	GTGCGATC
GTGCGAGT	GTGCGATC
GTCCTTGG	GTCTTTGG
GATAGCTA	GAAGCTAG
TTGGCCAA	CTGGCCAA
GACGTTTA	AACGTTTA
TGATCCCT	TGACCCTT
GATAGTAT	GATAATAT
TGATCCTT	TGACCCTT
GATAGTTG	GATATTGG
GTGCGANC	GTGCGATC
GAAATACT	GCAATACT
GTGCGANT	GTGCGATC
GAAATATA	GATAATAT
GAAATATC	GATAATAT
GTGCGCAT	GTGCGATC
TTGGCTTC	GTGGCTTC
TNAAATGA	TAAATGAC
GTGCGCTC	GTGCGATC
GTGCGCTT	GTGGCTTC
TGGTCAAA	TGGATCAA
TNAAAGAT	TAAAGATT
TGGTCAAC	TGGATCAA
TGGTCAAT	TGGATCAA
TGACCGCT	TGACCCTT
TNCCATGC	TCCCATGC
TTGNGGGC	TTGTGGGC
GGCTNAGT	GGCTAGTT
TGACCGTT	TGACCCTT
GATAGTGG	GATATTGG
TGGTCAAG	TGGATCAA
TGGTCAAN	TGGATCAA
TNAGACTA	TGAGACTA
GAAATATT	GATAATAT
GAAATATG	GATAATAT
TTGCAAAA	TTCAAAAG
GAAATATN	GATAATAT
TGGTCAGG	TGGTGAGG
GTGCGTAT	GTGCGATC
GTGCGTCA	GTGCGATC
GTGCGTCC	GTGCGATC
GTGCGTCT	GTGCGATC
GTGCGTCG	GTGCGATC
GTGCGTCN	GTGCGATC
TGTCCGGG	CGTCCGGG
GGAGACTA	TGAGACTA
GTGCGTTC	GTGCGATC
GAGGGATC	GGGGATCC
GGAGATAC	GGGATACA
GTGCGGAT	GTGCGATC
GTCCGACC	GTCCACCT
GGAGATCC	GGGGATCC
GTCCGATC	GTGCGATC
GTGCGGTC	GTGCGATC
TGACCNCT	TGACCCTT
TGACCNTT	TGACCCTT
GTTACAGG	ATTACAGG
GGAGAGAC	GGCGAGAC
TGTAGAAA	CGTAGAAA
GTCCGCCT	GTCCACCT
TGTAGACT	TGAGACTA
GTTACCCT	TTTACCCT
GATANATA	GATAATAT
TGTGTGAG	TGGTGAGG
GAAATTGG	GATATTGG
TNAGAGCA	TAGAGCAG
GTGCGNAT	GTGCGATC
GTGCGNTC	GTGCGATC
GGCTNGTT	GGCTAGTT
GAGGGTGA	GCGGGTGA
TGTAGTAA	TTAGTAAC
TNCGCTGG	TCGCTGGC
GCACGACA	CGCACGAC
GTTACTAC	GTTCTACG
GCACGACC	CGCACGAC
GCACGACT	CGCACGAC
GCACGACG	CGCACGAC
GCACGACN	CGCACGAC
TGTGTGGG	TTGTGGGC
GAAATGAC	TAAATGAC
GCACGCAT	GAACGCAT
TNCCCATG	TCCCATGC
GAAATGCA	AGAAATGC
GAAATGCC	AGAAATGC
GAAATGCT	AGAAATGC
GAAATGCG	AGAAATGC
TGGTCTGC	GGGTCTGC
GAAATGCN	AGAAATGC
TGATTAAC	TGATAACC
TGATTACC	TGATAACC
GTGCNATC	GTGCGATC
TGGTCGAG	TGGTGAGG
GGAGCTAG	GAAGCTAG
GGCCGAGA	GGCGAGAC
GGCGAAAC	GGCGAGAC
GATANTAT	GATAATAT
GGCGAACA	GGCGAGAC
GTCCGGGA	CGTCCGGG
GGCGAACC	GGCGAGAC
GTCCGGGC	CGTCCGGG
GGCGAACT	GGCGAGAC
GTCCGGGT	CGTCCGGG
GGAGCGCG	AGAGCGCG
GGCGAACG	GGCGAGAC
GTCCGGGG	CGTCCGGG
GGCGAACN	GGCGAGAC
GTCCGGGN	CGTCCGGG
GATANTTG	GATATTGG
GGCGAAGA	GGCGAGAC
TGGTCGTA	GGGTCGTA
GATANTGG	GATATTGG
TGTGGAAC	TCTGGAAC
GATNTTGG	GATATTGG
TGTCTTTG	GTCTTTGG
GAAAGATT	TAAAGATT
TGANCCCT	TGACCCTT
GGCGACAC	GGCGAGAC
TGANCCTT	TGACCCTT
GTNCTACG	GTTCTACG
GGCGACGA	GGCGAGAC
TGCTTTTT	GCTTTTTA
GTTATAAC	GGTATAAC
GTCCNACC	GTCCACCT
GTTATACG	GTTCTACG
GGCGATAG	GGCATAGA
GGCGATCA	GTGCGATC
GGAGTCTG	GGGTCTGC
TGTGGCTT	GTGGCTTC
GGAGTCGT	GGGTCGTA
GTCGGACT	TCGGACTT
GAAAGCAT	GAACGCAT
GAAAGCTA	GAAGCTAG
GAAAGCTC	AAAGCTCG
GTGCNGAT	GTGCGATC
TTCGCTGG	TCGCTGGC
GTAAGCTA	GAAGCTAG
GCACGGCA	GCAACGGC
GCACGGCC	GCAACGGC
GCCTAACA	CCTAACAG
GTCCNCCT	GTCCACCT
GGCGATCT	GTGCGATC
GGCGATCG	GTGCGATC
GGCGATCN	GTGCGATC
GGCGATGA	GGCGAGAC
GGCCGTTC	AGCCGTTC
GCTCCACC	GTCCACCT
GGCGAGAA	GGCGAGAC
GGCGAGAC	GGCGAGAC
GGCGAGAT	GGCGAGAC
GGCGAGAG	GGCGAGAC
GGCGAGAN	GGCGAGAC
GGCGAGCA	GGCGAGAC
GGCGAGCC	GGCGAGAC
GGCGAGCT	GGCGAGAC
GGCGAGCG	GGCGAGAC
GGCGAGCN	GGCGAGAC
GGCGAGTA	GGCGAGAC
GGCGAGTC	GGCGAGAC
GATCAATA	GATAATAT
GGCGAGTT	GGCTAGTT
GGCGAGGA	GGCGAGAC
TGTGGGAA	GGTGGGAA
GCACGGCT	GCAACGGC
TGTGGGCA	TTGTGGGC
GCTCCCGA	ACTCCCGA
GCACGGCG	GCAACGGC
TGTGGGCC	TTGTGGGC
GCACGGCN	GCAACGGC
TGTGGGCT	TTGTGGGC
TGTGGGCG	TTGTGGGC
TGTGGGCN	TTGTGGGC
GTAAGGGG	TAAGGGGC
GATTCCTC	ATTCCTCC
GTCGGCTT	GTGGCTTC
GTNCTTTG	GTCTTTGG
GGAGGATC	GGGGATCC
GATTCTAC	GTTCTACG
GTTATTGG	GATATTGG
GGCGAGGC	GGCGAGAC
GACGGGTG	GCGGGTGA
GGCGAGNA	GGCGAGAC
GGCGAGNC	GGCGAGAC
GCAAAACT	GCAATACT
GGCGANAC	GGCGAGAC
TGNTAACC	TGATAACC
TGCTGAAA	TCTGAAAG
GATTCTGA	GGTTCTGA
GCGTGTGA	GCGGGTGA
GGCGANGA	GGCGAGAC
TTCGTAAC	TTAGTAAC
GCGCTAGT	GGCTAGTT
GCCTATAC	GCCTTTAC
TGCTGAGG	TGGTGAGG
GATCATAT	GATAATAT
GCGTGGTG	GCGGGTGA
GCGTGGGA	GGTGGGAA
GATCATTG	GATATTGG
GCAAACTA	GCAATACT
GCAAACTC	GCAATACT
GCAAACTT	GCAATACT
GCAAACTG	GCAATACT
GCAAACTN	GCAATACT
GGCGCAGA	GGCGAGAC
GCAAACGG	GCAACGGC
GCTCTACG	GTTCTACG
GCAAATAC	GCAATACT
TGANTAAC	TGATAACC
GTTAGTAA	TTAGTAAC
GCCTATTA	GCCTTTAC
GTCGGGAC	TCGGGACC
TGCTGGAA	TCTGGAAC
TGCTGGCA	TCGCTGGC
TGCTGGCC	TCGCTGGC
TGCTGGCT	TCGCTGGC
GCGCTTTA	GCCTTTAC
TGCTGGCG	TCGCTGGC
TGCTGGCN	TCGCTGGC
TNACATGG	TACATGGA
GTNCGATC	GTGCGATC
TGATGAAC	TGATAACC
TGATGACC	TGATAACC
TGATGACT	TGAGACTA
GGAGGGAA	GGTGGGAA
NACTCATC	ACTCATCC
NACTCAGT	AACTCAGT
GTGTATAA	GGTATAAC
GCAAAGTC	CCAAAGTC
GCAAAGGC	GCAACGGC
NACTCCCG	ACTCCCGA
GTCGGGTG	GCGGGTGA
GCCTAGTT	GGCTAGTT
GCCTAGGA	CCTAGGAA
NACTCTCG	CACTCTCG
GGCGCGAC	GGCGAGAC
GCGCTGGC	TCGCTGGC
TGATGAGG	TGGTGAGG
GGACCCTC	GACCCTCA
GGACCCTT	TGACCCTT
GCTCTTTT	GCTTTTTA
GCTCTTTG	GTCTTTGG
TNAGTAAC	TTAGTAAC
TNGTGAGG	TGGTGAGG
TTCGTGGG	TTGTGGGC
GCCGACTT	CCGACTTG
GCGNGTGA	GCGGGTGA
GATCCACC	GTCCACCT
GGCGTATC	AGCGTATC
NACTTCCA	ACTTCCAT
GANACGCA	GAACGCAT
GTTCAAAA	TTCAAAAG
GCAACACT	GCAATACT
GANTAATA	GATAATAT
GTTCAACG	GTTCTACG
TNACCCTT	TGACCCTT
GCGNGGTG	GCGGGTGA
GATTTTAC	AATTTTAC
TNTGAAAG	TCTGAAAG
GGCGTAGT	GGCTAGTT
GATTTTTA	GCTTTTTA
GCATAATA	GATAATAT
GTTCACCT	GTCCACCT
GCCGAGAC	GGCGAGAC
GTTCACGA	GTTCTACG
GTTCACGC	GTTCTACG
GATCCCTC	GACCCTCA
GTTCACGT	GTTCTACG
GTTCACGG	GTTCTACG
GTTCACGN	GTTCTACG
GCGCGATC	GTGCGATC
GGCGTCTG	GGGTCTGC
GCGCGAGA	GGCGAGAC
GTTCATAC	GTTCTACG
GGCGTCGT	GGGTCGTA
GCAACAGC	GCAACGGC
GCAACAGG	GCAACGGC
GATCCTCA	GACCCTCA
TNGTGGGC	TTGTGGGC
GCAACCTA	CAACCTAA
TTGAAAAT	TTAAAATA
TTGAAAAG	TTCAAAAG
GGACTAGT	GGCTAGTT
GCNTTTAC	GCCTTTAC
GATTTTGG	GATATTGG
TTGAAATA	TTAAAATA
GCNTTTTA	GCTTTTTA
TTGAAAGA	TCTGAAAG
GCNTTTTT	GCTTTTTA
TTGAAAGC	TCTGAAAG
TTGAAAGT	TCTGAAAG
GCATACTA	GCAATACT
TTGAAAGG	TCTGAAAG
GCATACTC	GCAATACT
TTGAAAGN	TCTGAAAG
NACTGAGG	ACTGAGGA
GCAACCGC	GCAACGGC
GCTNTTTA	GCTTTTTA
GCAACCGG	GCAACGGC
GCTNTTTT	GCTTTTTA
TTGCTGGC	TCGCTGGC
GATTTGGA	GATATTGG
GATTTGGC	GATATTGG
GATTTGGT	GATATTGG
GCAACTAC	GCAATACT
GATTTGGG	GATATTGG
GATTTGGN	GATATTGG
GTTCNACG	GTTCTACG
GGCGTGAC	GGCGAGAC
GCCTCTAC	GCCTTTAC
GANTATTG	GATATTGG
GCAACTGC	GCAACGGC
GCAACTGG	GCAACGGC
GTTCCACC	GTCCACCT
GTACACCT	GTCCACCT
GTTCCACG	GTTCTACG
GCCTCTTA	GCCTTTAC
TTCGGACT	TCGGACTT
GTGTCTAC	GTTCTACG
GTTCNTAC	GTTCTACG
GTGTCTTC	GTGGCTTC
GCAACGAC	GCAACGGC
GCAACGAG	GCAACGGC
GCAACGCC	GCAACGGC
GCAACGCT	GCAACGGC
GCAACGCG	GCAACGGC
NACTGTTT	CACTGTTT
GCAACGCN	GCAACGGC
GCGGACTT	TCGGACTT
GCAACGTC	GCAACGGC
GCAACGTG	GCAACGGC
GGCTAATT	GGCTAGTT
GCAACGGA	GCAACGGC
TTGCTGGG	TTGTGGGC
GCAACGGC	GCAACGGC
GCAACGGT	GCAACGGC
GCAACGGG	GCAACGGC
GGCTAAGT	GGCTAGTT
GCAACGGN	GCAACGGC
GCAACGNC	GCAACGGC
GCGCGTGA	GCGGGTGA
GCATACTT	GCAATACT
GCATACTG	GCAATACT
GCATACTN	GCAATACT
GCATACGG	GCAACGGC
GCATATAC	GCAATACT
GCGCGGTG	GCGGGTGA
GCGGATAC	GGGATACA
GGCGGACA	GGCGAGAC
GCGGATCC	GGGGATCC
GGCGGACC	GGCGAGAC
GGCGGACT	GGCGAGAC
GGCGGACG	GGCGAGAC
GGCGGACN	GGCGAGAC
GGCGGATC	GGGGATCC
GTTCCTAC	GTTCTACG
GCGGATGA	GCGGGTGA
GGCGGAGA	GGCGAGAC
TGATNAAC	TGATAACC
GTTCCTCC	ATTCCTCC
TGATNACC	TGATAACC
GTACATGG	TACATGGA
GCAACGNG	GCAACGGC
GATCTACG	GTTCTACG
GCAACNGC	GCAACGGC
GCAACNGG	GCAACGGC
GTGTCTGC	GGGTCTGC
GCATATTG	GATATTGG
GCATATGC	CCATATGC
GTGTCGAT	GTGCGATC
TTGCGATC	GTGCGATC
GCATAGAA	GGCATAGA
GCATAGAC	GGCATAGA
GCATAGAT	GGCATAGA
GCATAGAG	GGCATAGA
GGCTACTT	GGCTAGTT
GCATAGAN	GGCATAGA
GGCTACGT	GGCTAGTT
GGCTATAA	GGTATAAC
GGCTATAG	GGCATAGA
GCGGAGTG	GCGGGTGA
GCCTTAAC	GCCTTTAC
GCCTTACA	GCCTTTAC
GCCTTACC	GCCTTTAC
GCCTTACT	GCCTTTAC
GCCTTACG	GCCTTTAC
GCCTTACN	GCCTTTAC
GCCTTATA	GCCTTTAC
GCAATAAC	GCAATACT
GCAATAAT	GCAATACT
GCAATACA	GCAATACT
GCAATACC	GCAATACT
GTGTCGTA	GGGTCGTA
GCAATACT	GCAATACT
GCAATACG	GCAATACT
GCAATACN	GCAATACT
GGACGAGA	GGCGAGAC
GCAATATA	GCAATACT
GCAATATC	GCAATACT
GCAATATT	GCAATACT
GCAATATG	GCAATACT
GCAATATN	GCAATACT
GCAATAGC	GCAATACT
GCAATAGT	GCAATACT
GANATTGG	GATATTGG
GCAATANC	GCAATACT
GCAATANT	GCAATACT
TTCGGGAC	TCGGGACC
GGCTATTA	GGCTAGTT
GGCTATTC	GGCTAGTT
GGCTATTT	GGCTAGTT
GGCTATTG	GGCTAGTT
GGCTATTN	GGCTAGTT
GGCTATGT	GGCTAGTT
GTTGTACG	GTTCTACG
GCCTTCAC	GCCTTTAC
GGCTAGAA	GGCATAGA
GTCNACCT	GTCCACCT
GCCTTCTA	GCCTTTAC
GGCTAGAG	GGCATAGA
GGCTAGAN	GGCATAGA
GGACGCAT	GAACGCAT
GATCTTTG	GTCTTTGG
GGCTAGCT	GGCTAGTT
GATCTTGG	GATATTGG
GGCTAGTA	GGCTAGTT
GGCTAGTC	GGCTAGTT
GGCTAGTT	GGCTAGTT
GGCTAGTG	GGCTAGTT
GGCTAGTN	GGCTAGTT
GGCGGGAA	GGTGGGAA
GGCGGGAC	GGCGAGAC
GCCTTTAA	GCCTTTAC
GCCTTTAC	GCCTTTAC
GCCTTTAT	GCCTTTAC
GCCTTTAG	GCCTTTAC
GTTTACCC	TTTACCCT
GCCTTTAN	GCCTTTAC
GCCTTTCA	GCCTTTAC
GCCTTTCC	GCCTTTAC
GCAATCAC	GCAATACT
GGCGGGTG	GCGGGTGA
TGTTAACC	TGATAACC
GAGATACA	GGGATACA
GCAATCCT	GCAATACT
GTACCACC	GTCCACCT
GCAATCTA	GCAATACT
GCAATCTC	GCAATACT
GCAATCTT	GCAATACT
GCAATCTG	GCAATACT
GCAATCTN	GCAATACT
GGCNTAGA	GGCATAGA
GGCNTAGT	GGCTAGTT
GCAATCGG	GCAACGGC
GGCTAGGT	GGCTAGTT
GTTCTAAC	GTTCTACG
GTTTACGA	GTTCTACG
GCCTTTCT	GCCTTTAC
GTTTACGC	GTTCTACG
GCCTTTCG	GCCTTTAC
GGCTAGNT	GGCTAGTT
GTTTACGT	GTTCTACG
GCCTTTCN	GCCTTTAC
GTTTACGG	GTTCTACG
GCCTTTTC	GCCTTTAC
GTTTACGN	GTTCTACG
GCCTTTTT	GCTTTTTA
GCCTTTGA	GCCTTTAC
GCCTTTGC	GCCTTTAC
GCCTTTGG	GTCTTTGG
GCCTTTNA	GCCTTTAC
GCCTTTNC	GCCTTTAC
GAGAAATG	AGAAATGC
GCCTTGAC	GCCTTTAC
GCAATTAC	GCAATACT
GCCTTGTA	GCCTTTAC
GCAATTCT	GCAATACT
GTACCCTC	GACCCTCA
GTTCTAAG	GTTCTACG
GTTCTACA	GTTCTACG
GTTCTACC	GTTCTACG
GTTCTACT	GTTCTACG
GTTCTACG	GTTCTACG
TGTTACCC	TTTACCCT
GTTCTACN	GTTCTACG
GTTCTATC	GTTCTACG
GATGAATA	GATAATAT
GTTCTATG	GTTCTACG
GGCTANTT	GGCTAGTT
GTCTACCT	GTCCACCT
GTTCTAGA	GTTCTACG
GTTCTAGC	GTTCTACG
GTTCTAGT	GTTCTACG
GTTCTAGG	GTTCTACG
GGCTANGT	GGCTAGTT
GTTCTAGN	GTTCTACG
GTTCTANC	GTTCTACG
GTCTACGA	GTTCTACG
GTTCTANG	GTTCTACG
GTCTACGC	GTTCTACG
GTCTACGT	GTTCTACG
GCCTTGGT	ACCTTGGT
GTCTACGG	GTTCTACG
GCNCTTTA	GCCTTTAC
GTTCTCAC	GTTCTACG
GTCTACGN	GTTCTACG
GTGTTCTG	GGTTCTGA
TTGCGGGC	TTGTGGGC
GTTCTCCG	GTTCTACG
GCCTTNAC	GCCTTTAC
GCGGCCCA	CGGCCCAT
GCTAAACG	ACTAAACG
GCNAACGG	GCAACGGC
GTTCTCGA	GTTCTACG
GTTCTCGC	GTTCTACG
GTTCTCGT	GTTCTACG
GCCTTNTA	GCCTTTAC
GTTCTCGG	GTTCTACG
GGCTCAGT	GGCTAGTT
GTTCTCGN	GTTCTACG
GCNAATAC	GCAATACT
GTGGCATC	GTGGCTTC
GTGGCATT	GTGGCTTC
GTTCTTAC	GTTCTACG
GGCGNAGA	GGCGAGAC
GTTCTTCG	GTTCTACG
GTGGCCAA	CTGGCCAA
GCAATGAC	GCAATACT
GTTCTTTG	GTCTTTGG
GCAATGCT	GCAATACT
GTCTATTG	GTCTTTGG
GTTCTGAA	GGTTCTGA
GTCTATGG	GTCTTTGG
GTTCTGAT	GGTTCTGA
GCCAAAGT	CCAAAGTC
GTTCTGAG	GGTTCTGA
GTTCTGAN	GGTTCTGA
GAGATTGG	GATATTGG
GTGTTTGG	GTCTTTGG
GANAGCTA	GAAGCTAG
GTTCTGCG	GTTCTACG
GAGAATAT	GATAATAT
GCTAACAG	CCTAACAG
GGCTCTGA	GGTTCTGA
GGCTCTGC	GGGTCTGC
GTGGCCTC	GTGGCTTC
NACGAAGG	ACGAAGGG
GTGGCCTT	GTGGCTTC
GTTCTNAC	GTTCTACG
GCGGCTTC	GTGGCTTC
GCAATGGC	GCAACGGC
GCGGCTGA	GCGGGTGA
GCTAACGG	GCAACGGC
GTTCTNCG	GTTCTACG
GAGTAATA	GATAATAT
GGCTCGTA	GGGTCGTA
GCAATNAC	GCAATACT
GGCTCGTT	GGCTAGTT
GCCGTTAC	GCCTTTAC
GCCGTTCA	AGCCGTTC
GCAATNCT	GCAATACT
GCCGTTCC	AGCCGTTC
GCCAACGG	GCAACGGC
GCGGCGTG	GCGGGTGA
GTTCGACG	GTTCTACG
GCCAATAC	GCAATACT
GTTCGATC	GTGCGATC
GATCGCAT	GAACGCAT
GGATAACA	GGTATAAC
GGATAACT	GGTATAAC
GGATAACG	GGTATAAC
GTGGCTAC	GTGGCTTC
GGATAACN	GGTATAAC
GTCTAGTT	GGCTAGTT
GTGGCTAT	GTGGCTTC
GGATAATA	GATAATAT
GCATCGGC	GCAACGGC
GCATCGGT	CATCGGTC
GTGGCTCA	GTGGCTTC
GTGGCTCC	GTGGCTTC
GTGGCTCT	GTGGCTTC
GTGGCTCG	GTGGCTTC
GTGGCTCN	GTGGCTTC
GTGGCTTA	GTGGCTTC
GTCNCACC	GTCCACCT
GTGGCTTC	GTGGCTTC
GATGATAT	GATAATAT
GTGGCTTT	GTGGCTTC
GTGGCTTG	GTGGCTTC
GTGGCTTN	GTGGCTTC
GTGGCTGC	GTGGCTTC
GGATACAA	GGGATACA
GTGGCTGT	GTGGCTTC
GGATACAC	GGGATACA
GGATACAT	GGGATACA
GGATACAG	GGGATACA
GGATACAN	GGGATACA
GTGGCTNC	GTGGCTTC
GTNTCTAC	GTTCTACG
GGCTTAGA	GGCATAGA
GTGGCTNT	GTGGCTTC
GATGATTG	GATATTGG
GGCTTAGT	GGCTAGTT
GAGTACTC	CAGTACTC
GTTGTGGG	TTGTGGGC
GTGGCGAT	GTGCGATC
GCCGTTCT	AGCCGTTC
GCTAATAC	GCAATACT
GCCGTTCG	AGCCGTTC
GCTAATAT	GATAATAT
GCCGTTCN	AGCCGTTC
GTTCGTAC	GTTCTACG
GCCGTTTA	GCCTTTAC
GTGGCGTC	GTGGCTTC
GAGTATAA	GGTATAAC
GGATATAA	GGTATAAC
GCAGCCGG	ACAGCCGG
GGCTTCTG	GGTTCTGA
GCAAGACT	GCAATACT
GTACTACG	GTTCTACG
GGATATTG	GATATTGG
GGCTTTAC	GCCTTTAC
GTGTGATC	GTGCGATC
GGATAGAA	GGCATAGA
GGCGNGAC	GGCGAGAC
GGATAGAC	GGCATAGA
GGCTTTTT	GCTTTTTA
GGATAGAT	GGCATAGA
GGATAGAG	GGCATAGA
GGATAGAN	GGCATAGA
GTGGCGTT	GTGGCTTC
GCAGCTAG	GAAGCTAG
GGATAGTT	GGCTAGTT
GAGTATTG	GATATTGG
GCTTATTA	GCTTTTTA
GATCGGTC	CATCGGTC
GCTTATTT	GCTTTTTA
GCCTGTAC	GCCTTTAC
GCATTACT	GCAATACT
GGCTTTGG	GTCTTTGG
GCCTGTTA	GCCTTTAC
GCAAGCTA	GAAGCTAG
GGATCAAA	TGGATCAA
GGATCAAC	TGGATCAA
GGATCAAT	TGGATCAA
GGATCAAG	TGGATCAA
GGATCAAN	TGGATCAA
GCAAGCGG	GCAACGGC
GTACTCGT	CTACTCGT
GGCTTGTT	GGCTAGTT
GTGTGCCA	CTGTGCCA
GTCTCACC	GTCCACCT
GTGTGCTT	GTGGCTTC
GAGAGCAG	TAGAGCAG
GCAGCGGC	GCAACGGC
GAGAGCTA	GAAGCTAG
GAGAGCTT	CAGAGCTT
GAGAGCGC	AGAGCGCG
GTNTTTGG	GTCTTTGG
GTGGCNTC	GTGGCTTC
GTGGCNTT	GTGGCTTC
GCGGTCTG	GGGTCTGC
GTTTCTAC	GTTCTACG
GCGGTCGT	GGGTCGTA
GCAAGTAC	GCAATACT
GTACTTTG	GTCTTTGG
GGCNGAGA	GGCGAGAC
GTTGGCTT	GTGGCTTC
GCGTATAA	GGTATAAC
TGTTCTAC	GTTCTACG
GCGTATCA	AGCGTATC
GCGTATCC	AGCGTATC
GAGACTAA	TGAGACTA
GCGTATCT	AGCGTATC
GAGACTAC	TGAGACTA
GCGTATCG	AGCGTATC
GAGACTAT	TGAGACTA
GCGTATCN	AGCGTATC
GAGACTAG	TGAGACTA
GAGACTAN	TGAGACTA
GTCTCTAC	GTTCTACG
GCGGTTGA	GCGGGTGA
GGATCTGA	GGTTCTGA
GGATCTGC	GGGTCTGC
GTTTCTGA	GGTTCTGA
GTCTCTTG	GTCTTTGG
GCGGTGAA	GCGGGTGA
GCGGTGAC	GCGGGTGA
GTCTCTGG	GTCTTTGG
GCGGTGAT	GCGGGTGA
GCGGTGAG	GCGGGTGA
GCGGTGAN	GCGGGTGA
NATTACAG	ATTACAGG
GCGGTGTG	GCGGGTGA
GACNCCTC	GACCCTCA
GTGTGGGA	GGTGGGAA
GTGTGGGC	TTGTGGGC
GTGGTCTT	GTGGCTTC
GTGGTCTG	GGGTCTGC
GCATTTAC	GCCTTTAC
GCAAGGCA	GCAACGGC
GCNACGGC	GCAACGGC
GCAAGGCC	GCAACGGC
GCAAGGCT	GCAACGGC
GCAAGGCG	GCAACGGC
GCAAGGCN	GCAACGGC
GCAAGGGC	GCAACGGC
TGTTCTGA	GGTTCTGA
GCCACCTA	GTCCACCT
GCTACTCG	CTACTCGT
GCCACCTC	GTCCACCT
GCCACCTT	GTCCACCT
GCCACCTG	GTCCACCT
GCCACCTN	GTCCACCT
GGATCGTA	GGGTCGTA
GCGTAGAA	CGTAGAAA
GAGTCAGT	AGTCAGTT
GTNGCTTC	GTGGCTTC
GAGACGCA	GAACGCAT
GCTTCCAT	ACTTCCAT
GTGGTCGT	GGGTCGTA
GACNCTCA	GACCCTCA
GTGGTTCA	GTGGCTTC
GCATTTTA	GCTTTTTA
GTGGTTCC	GTGGCTTC
GTGGTTCT	GTGGCTTC
GCATTTTT	GCTTTTTA
GTGGTTCG	GTGGCTTC
GTNGCGAT	GTGCGATC
GTTGGGAA	GGTGGGAA
NATTATGT	AATTATGT
GCNATACT	GCAATACT
GTGGTTCN	GTGGCTTC
GTGGTTTC	GTGGCTTC
GCGGGACC	TCGGGACC
GCGGGATC	GGGGATCC
GCGGGATG	GCGGGTGA
GTGGTGAG	TGGTGAGG
GCGGGAGA	GCGGGTGA
GTCTTATG	GTCTTTGG
GTCTTAGG	GTCTTTGG
GCTTCTAC	GTTCTACG
GATGCTAG	GAAGCTAG
GCGGGCTG	GCGGGTGA
GCGGGCGA	GCGGGTGA
GTGACCCT	TGACCCTT
GCGGGTAA	GCGGGTGA
GCGGGTAC	GCGGGTGA
GCGGGTAT	GCGGGTGA
GCGGGTAG	GCGGGTGA
GCGGGTAN	GCGGGTGA
GCCTNTAC	GCCTTTAC
GTACGATC	GTGCGATC
GCGGGTCA	GCGGGTGA
GCGGGTCG	GCGGGTGA
GCGGGTTA	GCGGGTGA
GCGGGTTG	GCGGGTGA
GCCTNTTA	GCCTTTAC
GGATTCTG	GGTTCTGA
GCGGGTGA	GCGGGTGA
GCGGGTGC	GCGGGTGA
GCGGGTGT	GCGGGTGA
GCGGGTGG	GCGGGTGA
GCGGGTGN	GCGGGTGA
GCGGGTNA	GCGGGTGA
GTACGCAT	GAACGCAT
GTGACTTC	GTGGCTTC
GCGGGTNG	GCGGGTGA
GCGAACGG	GCAACGGC
GCGGGGAA	GCGGGTGA
GCGGGGAC	GCGGGTGA
GGCAAAGA	GGCATAGA
GCGGGGAT	GCGGGTGA
GCGGGGAG	GCGGGTGA
GCGGGGAN	GCGGGTGA
NATTCCTC	ATTCCTCC
GGCAACGG	GCAACGGC
GCAANACT	GCAATACT
GCTACGGC	GCAACGGC
GCTTCTTA	GCTTTTTA
GCGGGGTG	GCGGGTGA
GTGACGAT	GTGCGATC
GCTTCTTT	GCTTTTTA
GCGGGGGA	GCGGGTGA
GCTTCTGA	GGTTCTGA
GCCACGGC	GCAACGGC
GTAAAAAT	TAAAAATC
GCGAATAC	GCAATACT
GTCNTTTG	GTCTTTGG
GTCNTTGG	GTCTTTGG
GTTTTACG	GTTCTACG
GAGTCTGC	GGGTCTGC
GCCGGTGA	GCGGGTGA
GCGGGNTG	GCGGGTGA
GTCTTCTG	GTCTTTGG
GAGTCGTA	GGGTCGTA
GTCTTCGG	GTCTTTGG
GATTAATA	GATAATAT
GCCGGGTG	GCGGGTGA
GATGCGAT	GTGCGATC
GTCTTTAC	GCCTTTAC
GTCTTTAG	GTCTTTGG
GTAAAATA	TTAAAATA
GCTATAAC	GGTATAAC
GCGGGNGA	GCGGGTGA
GGGAGACC	GGCGAGAC
GGCNATAG	GGCATAGA
GCTATACT	GCAATACT
GTGGGAAA	GGTGGGAA
GGGAGACT	GGCGAGAC
GTGGGAAC	GGTGGGAA
GGGAGACG	GGCGAGAC
GTGGGAAT	GGTGGGAA
GGGAGACN	GGCGAGAC
GTGGGAAG	GGTGGGAA
GTGGGAAN	GGTGGGAA
GGGAGATC	GGGGATCC
GTGATAAC	TGATAACC
GCCATACT	GCAATACT
GTGATACA	GGGATACA
GCGAAGGG	ACGAAGGG
GTCTTTCG	GTCTTTGG
GCCATATG	CCATATGC
GCCATAGA	GGCATAGA
GGCAATAC	GCAATACT
GTCTTTTT	GCTTTTTA
GGCAATAG	GGCATAGA
GTCTTTTG	GTCTTTGG
GATTACAG	ATTACAGG
GTCTTTGA	GTCTTTGG
GTCTTTGC	GTCTTTGG
GTCTTTGT	GTCTTTGG
GTCTTTGG	GTCTTTGG
GTCTTTGN	GTCTTTGG
GCTTTACA	GCCTTTAC
GTCTTTNG	GTCTTTGG
GTTTTTAA	GCTTTTTA
GTTTTTAC	GCTTTTTA
GTTTTTAT	GCTTTTTA
GCGTCCGG	CGTCCGGG
GTTTTTAG	GCTTTTTA
GTTTTTAN	GCTTTTTA
GCAANCGG	GCAACGGC
GTCTTGTG	GTCTTTGG
GATTATAT	GATAATAT
GCTTTACC	GCCTTTAC
GCTTTACT	GCCTTTAC
GCTTTACG	GCCTTTAC
GTAAATGA	TAAATGAC
GCTTTACN	GCCTTTAC
GCTTTATA	GCTTTTTA
GCTTTATT	GCTTTTTA
GTAAAGAT	TAAAGATT
GTCTTGGA	GTCTTTGG
GTCTTGGC	GTCTTTGG
GTATCTAC	GTTCTACG
GTCTTGGT	GTCTTTGG
GTCTTGGG	GTCTTTGG
GTCTTGGN	GTCTTTGG
GCCATTAC	GCCTTTAC
GATTATTG	GATATTGG
GCTTTCTA	GCTTTTTA
GATTATGT	AATTATGT
GCTTTCTT	GCTTTTTA
GCCATTTA	GCCTTTAC
GTTTTTTA	GCTTTTTA
GTCTTNTG	GTCTTTGG
GCAANTAC	GCAATACT
GTTTTTGG	GTCTTTGG
GAGTTCTG	GGTTCTGA
GGCNAGAC	GGCGAGAC
GTGGACTT	GTGGCTTC
GCTATTTA	GCTTTTTA
GTGGGCTT	GTGGCTTC
GCTATTTT	GCTTTTTA
GTCTTNGG	GTCTTTGG
GGCNAGTT	GGCTAGTT
NACGTTTA	AACGTTTA
GGCAAGAA	GGCATAGA
GTCTGAAA	TCTGAAAG
GGCAAGAT	GGCATAGA
GGCAAGAG	GGCATAGA
GGCAAGAN	GGCATAGA
GGCAAGTT	GGCTAGTT
GCTTTTAA	GCTTTTTA
GCTTTTAT	GCTTTTTA
GCTTTTAG	GCTTTTTA
GCTTTTAN	GCTTTTTA
GCTTTTCA	GCTTTTTA
GCTTTTCT	GCTTTTTA
GCTTTTTA	GCTTTTTA
GCTTTTTC	GCTTTTTA
GCTTTTTT	GCTTTTTA
GCGTCTGC	GGGTCTGC
GGGAGTAC	GGGATACA
GTGGATAC	GGGATACA
GTTTTGGA	GTCTTTGG
GTTTTGGC	GTCTTTGG
GTGGATCT	GTGCGATC
GTTTTGGT	GTCTTTGG
GTGGATCG	GTGCGATC
GTTTTGGG	GTCTTTGG
GTGGATCN	GTGCGATC
GTTTTGGN	GTCTTTGG
GCGTCGTA	GGGTCGTA
GTGGATTC	GTGGCTTC
GCTATTGG	GATATTGG
GCGGNTGA	GCGGGTGA
GTGGGTTC	GTGGCTTC
GCGACTTG	CCGACTTG
GGTTTAAC	GGTATAAC
NCCGACTT	CCGACTTG
GCTTTTTG	GCTTTTTA
GCTTTTTN	GCTTTTTA
GCTTTTGA	GCTTTTTA
GAGTTGCC	AGTTGCCT
GCTTTTGT	GCTTTTTA
GCTTTTNA	GCTTTTTA
GCTTTTNT	GCTTTTTA
GGATGGGA	GGTGGGAA
GCAANGGC	GCAACGGC
GANAATAT	GATAATAT
GTNCACCT	GTCCACCT
GCAGGCCC	CAGGCCCG
GCGGNGTG	GCGGGTGA
GCTTTGTA	GCTTTTTA
GCTTTGTT	GCTTTTTA
GCTTTGGA	GTCTTTGG
GCTTTGGT	GTCTTTGG
GCTTTGGG	GTCTTTGG
GCTTTGGN	GTCTTTGG
GTGGGTGA	GCGGGTGA
GATGTCGT	AATGTCGT
GCGACGGC	GCAACGGC
GTGAGACT	TGAGACTA
GTGAGATC	GTGCGATC
GAGCACCC	AAGCACCC
GGTTTCTG	GGTTCTGA
GGCACAGA	GGCATAGA
NCCAAAGT	CCAAAGTC
GTCTGTTG	GTCTTTGG
GTCTGTGG	GTCTTTGG
GCTTTNTA	GCTTTTTA
GCTTTNTT	GCTTTTTA
GTCTGGAA	TCTGGAAC
GGTTTTTA	GCTTTTTA
GTNGGCTT	GTGGCTTC
GGTTTTGA	GGTTCTGA
GCAGGTGA	GCGGGTGA
GTGAGCTT	GTGGCTTC
GATGTTGT	AATGTTGT
GCGATACA	GGGATACA
GATGTTGG	GATATTGG
GCGATACT	GCAATACT
GCAGGGTG	GCGGGTGA
GAGCATAG	GGCATAGA
GCAGGGGG	CAGGGGGG
GGTTTGAA	GGTTCTGA
GGTTTGAC	GGTTCTGA
GGTTTGAT	GGTTCTGA
GGTTTGAG	GGTTCTGA
GGTTTGAN	GGTTCTGA
GANCCCTC	GACCCTCA
NATTTTAC	AATTTTAC
GGTAAAAC	GGTATAAC
GCTTGTTA	GCTTTTTA
GCTTGTTT	GCTTTTTA
NCAGAGCT	CAGAGCTT
GANCCTCA	GACCCTCA
GCACAATG	ACACAATG
GCGTTCTG	GGTTCTGA
GGGANACA	GGGATACA
GCGTTTAC	GCCTTTAC
GGTAAACA	GGTATAAC
GGTAAACC	GGTATAAC
GGTAAACT	GGTATAAC
GGTAAACG	GGTATAAC
GGTAAACN	GGTATAAC
GGCACTAG	GGCATAGA
GCGTTTTA	GCTTTTTA
GGAAATGC	AGAAATGC
GGNATAAC	GGTATAAC
GGNATACA	GGGATACA
GTAACGCA	GAACGCAT
NAGGGGGG	CAGGGGGG
GGNATAGA	GGCATAGA
GCACACGG	GCAACGGC
GCGTTTTT	GCTTTTTA
NCAGCCGG	ACAGCCGG
GCACATAC	GCAATACT
GTGGNCTT	GTGGCTTC
GCTAGTTA	GGCTAGTT
GTNCCACC	GTCCACCT
GCTAGTTC	GGCTAGTT
GCTAGTTT	GGCTAGTT
GCTAGTTG	GGCTAGTT
GCTAGTTN	GGCTAGTT
GCTAGGAA	CCTAGGAA
GGTAATAA	GGTATAAC
GGTAATAT	GATAATAT
GTATTTGG	GTCTTTGG
GGGANTAC	GGGATACA
GCTTNTTA	GCTTTTTA
GCTTNTTT	GCTTTTTA
GGCACGAC	CGCACGAC
GTATAACA	GGTATAAC
GTATAACC	GGTATAAC
GTATAACT	GGTATAAC
GGTTGCCT	AGTTGCCT
GTATAACG	GGTATAAC
GTATAACN	GGTATAAC
GTATAATA	GATAATAT
GTATTGGA	GATATTGG
GTATTGGC	GATATTGG
GGTTGCTG	GGTTCTGA
GTATTGGT	GATATTGG
GTATTGGG	GATATTGG
GTATTGGN	GATATTGG
GTAACGGC	GCAACGGC
GTGGNTTC	GTGGCTTC
GTTAAAAT	TTAAAATA
GTCTNTTG	GTCTTTGG
NCAGTACT	CAGTACTC
GTCTNTGG	GTCTTTGG
NCCATATG	CCATATGC
GGTACAAC	GGTATAAC
GTTTGGCT	CTTTGGCT
GCGAGACA	GGCGAGAC
GCGAGACC	GGCGAGAC
GCGAGACT	GGCGAGAC
GCGAGACG	GGCGAGAC
GCGAGACN	GGCGAGAC
GGTTGTGA	GGTTCTGA
GAGTGGGA	GGTGGGAA
GCANACGG	GCAACGGC
GGTTGGAA	GGTGGGAA
GCANATAC	GCAATACT
GGCATAAA	GGCATAGA
GGCATAAT	GGCATAGA
GGCATAAG	GGCATAGA
GGCATAAN	GGCATAGA
GGCATACG	GGCATAGA
GGCATATA	GGCATAGA
GGCATATG	GGCATAGA
GGCATAGA	GGCATAGA
GGCATAGC	GGCATAGA
GGCATAGG	GGCATAGA
GGTACTAA	GGTATAAC
GATGGCTT	GTGGCTTC
GGCATAGN	GGCATAGA
GGCATANA	GGCATAGA
GGCATANG	GGCATAGA
GTAATACT	GCAATACT
GTAATATA	GATAATAT
GTAATATC	GATAATAT
GGCATCAG	GGCATAGA
GTAATATT	GATAATAT
GGTACTGA	GGTTCTGA
GGTTGGGA	GGTGGGAA
GGAACGCA	GAACGCAT
GTATATTG	GATATTGG
GGAACGGC	GCAACGGC
GNCGGGTG	GCGGGTGA
GCTGAAAG	TCTGAAAG
GTTAATAT	GATAATAT
GNTGCGAT	GTGCGATC
GTAATATG	GATAATAT
GTAATATN	GATAATAT
GGGCATAC	GGGATACA
GGGCATAG	GGCATAGA
GGGCATCC	GGGGATCC
GCACCCTC	GACCCTCA
GGCATCGA	GGCATAGA
GGCATTAG	GGCATAGA
GCGAGTGA	GCGGGTGA
GAGCCCTC	GACCCTCA
GGAATAAC	GGTATAAC
GGCATTGA	GGCATAGA
GANGCTAG	GAAGCTAG
GGCATGAA	GGCATAGA
GGCATGAC	GGCATAGA
GGCATGAT	GGCATAGA
GGCATGAG	GGCATAGA
GGCATGAN	GGCATAGA
GCGAGGTG	GCGGGTGA
GATGGGAA	GGTGGGAA
GGTATAAA	GGTATAAC
GGTATAAC	GGTATAAC
GTCGACCT	GTCCACCT
GGTATAAT	GGTATAAC
GGTATAAG	GGTATAAC
GGTATAAN	GGTATAAC
GAGCCCGC	AGCCCGCG
GGAATACA	GGGATACA
GGAATACT	GCAATACT
GGTATACC	GGTATAAC
GGTATACT	GGTATAAC
GGTATACG	GGTATAAC
GGTATACN	GGTATAAC
GGTATATA	GGTATAAC
GGAATAGA	GGCATAGA
GAGCCTCA	GACCCTCA
GGTATATC	GGTATAAC
GCACCGGC	GCAACGGC
GCNGGTGA	GCGGGTGA
GGTATAGC	GGTATAAC
GTGCAATC	GTGCGATC
GGTATANA	GGTATAAC
GGTATANC	GGTATAAC
GGCATGGA	GGCATAGA
GCTGAGGA	ACTGAGGA
GGTATCAA	GGTATAAC
GGTATCAC	GGTATAAC
NCAGGCCC	CAGGCCCG
GTCGATCA	GTGCGATC
GTCGATCC	GTGCGATC
GTCGATCT	GTGCGATC
GTCGATCG	GTGCGATC
GGCATNAG	GGCATAGA
GTCGATCN	GTGCGATC
GTGCACCT	GTCCACCT
GGTATCTG	GGTTCTGA
GGTTNCTG	GGTTCTGA
GGCATNGA	GGCATAGA
GGCAGACA	GGCGAGAC
GGCAGACC	GGCGAGAC
GGCAGACT	GGCGAGAC
NAATTATG	AATTATGT
GTGCATAG	GGCATAGA
GTGCATCA	GTGCGATC
GTGCATCC	GTGCGATC
GTGCATCT	GTGCGATC
GTGCATCG	GTGCGATC
GTGCATCN	GTGCGATC
GAGCCGTT	AGCCGTTC
GCCCACCT	GTCCACCT
GGTTNTGA	GGTTCTGA
GGTATTAA	GGTATAAC
GGTATTAC	GGTATAAC
GGTATTGG	GATATTGG
GTCGAGAC	GGCGAGAC
GTGCAGAT	GTGCGATC
GGTATGAA	GGTATAAC
GGTATGAC	GGTATAAC
GTTNCTAC	GTTCTACG
GCNGGGTG	GCGGGTGA
GGCAGACG	GGCGAGAC
NATATTGG	GATATTGG
GGCAGACN	GGCGAGAC
GCACTACT	GCAATACT
GGTATNAA	GGTATAAC
GGTATNAC	GGTATAAC
GNAACGCA	GAACGCAT
GCCCATGC	TCCCATGC
NAATTTTA	AATTTTAC
GTGCCACC	GTCCACCT
GNAACGGC	GCAACGGC
GTCGCACC	GTCCACCT
GTGCCATC	GTGCGATC
GGTAGAAA	CGTAGAAA
GGTAGAAC	GGTATAAC
NCAGGGGG	CAGGGGGG
GGNGGATC	GGGGATCC
GCAGACGG	GCAACGGC
GCACTCTC	CACTCTCG
GGGCCCAT	CGGCCCAT
GANCGCAT	GAACGCAT
GGTGATAA	GGTATAAC
GGTGATAC	GGGATACA
GGTGATCC	GGGGATCC
GTGCCTTC	GTGGCTTC
GGCAGTAG	GGCATAGA
GTCGCTTC	GTGGCTTC
GCACTTTA	GCCTTTAC
GGCAGTTA	GGCTAGTT
GAGCTAGA	GAAGCTAG
GTCGCTGG	TCGCTGGC
GGCAGTTC	GGCTAGTT
GAGCTAGC	GAAGCTAG
GGCAGTTT	GGCTAGTT
GAGCTAGG	GAAGCTAG
GAGCTAGN	GAAGCTAG
GTGCCGAT	GTGCGATC
GGTGAGAA	GGTGGGAA
GCAGATAC	GCAATACT
GGTNATAA	GGTATAAC
GGTGAGAC	GGCGAGAC
GTCGCGAT	GTGCGATC
GTTNTACG	GTTCTACG
GGAAGCTA	GAAGCTAG
GGTGAGGC	TGGTGAGG
GGTGAGGT	TGGTGAGG
GGTGAGGG	TGGTGAGG
GGTGAGGN	TGGTGAGG
GNGGATAC	GGGATACA
GGCAGTTG	GGCTAGTT
GGCAGTTN	GGCTAGTT
GNGGATCC	GGGGATCC
GCAGAGCT	CAGAGCTT
GCANCGGC	GCAACGGC
GGNGGGAA	GGTGGGAA
GAGGATAC	GGGATACA
GTAGAAAA	CGTAGAAA
GTAGAAAC	CGTAGAAA
GTAGAAAT	CGTAGAAA
GTAGAAAG	CGTAGAAA
GTAGAAAN	CGTAGAAA
GAGGATCC	GGGGATCC
GNAATACT	GCAATACT
GCACTGTT	CACTGTTT
GTGCTACG	GTTCTACG
GTGCTATC	GTGCGATC
GCTGCGAT	GTGCGATC
GTTGCCTA	AGTTGCCT
GTGCTAGT	GGCTAGTT
GTTGCCTC	AGTTGCCT
GTTGCCTT	AGTTGCCT
GTTGCCTG	AGTTGCCT
GTTGCCTN	AGTTGCCT
GGTAGTAA	GGTATAAC
GGGCCTGC	GGGTCTGC
GGTAGTTA	GGCTAGTT
GTTGCTAC	GTTCTACG
GGTAGTTC	GGCTAGTT
GGTAGTTT	GGCTAGTT
GGTAGTTG	GGCTAGTT
GATAAAAT	GATAATAT
GGTAGTTN	GGCTAGTT
GTTGCTTC	GTGGCTTC
GATAAATA	GATAATAT
GGTAGGAA	GGTGGGAA
GGGCCGTA	GGGTCGTA
GTGCTTCA	GTGGCTTC
GTGCTTCC	GTGGCTTC
GTGCTTCT	GTGGCTTC
GTGCTTCG	GTGGCTTC
GTGCTTCN	GTGGCTTC
GGTAGGGA	GGTGGGAA
GTGCTTTG	GTCTTTGG
GATAAATC	GATAATAT
GTTGCGAT	GTGCGATC
GATAAATT	GATAATAT
GATAAATG	GATAATAT
GATAAATN	GATAATAT
GTGCTGAT	GTGCGATC
GCCCCTCA	GACCCTCA
GCANTACT	GCAATACT
GNTGGCTT	GTGGCTTC
GTCGTTTG	GTCTTTGG
GGTGCTGA	GGTTCTGA
GTCGTTGG	GTCTTTGG
GTGNCTTC	GTGGCTTC
GTAGAGCA	TAGAGCAG
GGTGCGAA	GGTGGGAA
GATAACAT	GATAATAT
GGTGCGAT	GTGCGATC
NAATGTCG	AATGTCGT
GATAACCA	TGATAACC
NAATGTTG	AATGTTGT
GATAACCC	TGATAACC
GATAACCT	TGATAACC
GATAACCG	TGATAACC
NCCCATGC	TCCCATGC
GATAACCN	TGATAACC
GCTCATCC	ACTCATCC
GTGNCGAT	GTGCGATC
GATAACTA	GATAATAT
GGTGCGGA	GGTGGGAA
GGGCTACA	GGGATACA
GGGCTAGT	GGCTAGTT
GATAATAA	GATAATAT
NCTCATCC	ACTCATCC
GATAATAC	GATAATAT
GATAATAT	GATAATAT
GNTGGGAA	GGTGGGAA
GATAATAG	GATAATAT
GATAATAN	GATAATAT
GATAATCA	GATAATAT
GATAATCT	GATAATAT
GATAATTA	GATAATAT
GATAATTC	GATAATAT
GATAATTT	GATAATAT
GGGCTCTG	GGGTCTGC
GATAATTN	GATAATAT
GATAATGA	GATAATAT
GGTGTAAC	GGTATAAC
GGGCTCGT	GGGTCGTA
GCCCCGGC	CCCCGGCA
GATAATGT	GATAATAT
GATAATGG	GATATTGG
GATAATNA	GATAATAT
GNGCTAGT	GGCTAGTT
GATAATNT	GATAATAT
GCTGTTTA	GCTTTTTA
GGCANAGA	GGCATAGA
GCTGTTTT	GCTTTTTA
GATAAGAA	AATAAGAA
GGNTATAA	GGTATAAC
GGGCTTCA	GTGGCTTC
GATAAGAT	GATAATAT
GGGCTTCC	GTGGCTTC
GGGCTTCT	GTGGCTTC
GGGCTTCG	GTGGCTTC
GGGCTTCN	GTGGCTTC
GATAAGTA	GATAATAT
GCTGTGCC	CTGTGCCA
GGGCTGCA	GGGTCTGC
GGGCTGCC	GGGTCTGC
GGTGTCGT	GGGTCGTA
GGGCTGCT	GGGTCTGC
GGGCTGCG	GGGTCTGC
GGGCTGCN	GGGTCTGC
GTAGCTAG	GAAGCTAG
GATAANAT	GATAATAT
GGNTAGTT	GGCTAGTT
GTCAAAAG	TTCAAAAG
GTAGCTTC	GTGGCTTC
GATAANTA	GATAATAT
GAGCGATC	GTGCGATC
GGTGTGAA	GGTGGGAA
GCTGGAAC	TCTGGAAC
GGTGTGGA	GGTGGGAA
NCTCCCGA	ACTCCCGA
GGGCGAGA	GGCGAGAC
GGNCATAG	GGCATAGA
GTAGCGAT	GTGCGATC
GAGCGAGA	GGCGAGAC
GAGGCCCG	CAGGCCCG
GGCANTAG	GGCATAGA
NAGTACTC	CAGTACTC
GAGCGCAT	GAACGCAT
GCCNTTAC	GCCTTTAC
GATACATA	GATAATAT
GGTGGAAA	GGTGGGAA
GGTGGAAC	GGTGGGAA
GGTGGAAT	GGTGGGAA
GGTGGAAG	GGTGGGAA
GGTGGAAN	GGTGGGAA
GCCNTTTA	GCCTTTAC
GAGCGCGA	AGAGCGCG
GNTCTACG	GTTCTACG
GAGCGCGC	AGAGCGCG
GAGCGCGT	AGAGCGCG
GAGCGCGG	AGAGCGCG
GAGCGCGN	AGAGCGCG
GGGCGTAA	GGGTCGTA
GGTGGATC	GGGGATCC
GGGCGTAC	GGGTCGTA
GGGCGTAT	GGGTCGTA
GGGCGTAG	GGGTCGTA
GGGCGTAN	GGGTCGTA
GGTGGAGA	GGTGGGAA
GCTGGCCA	CTGGCCAA
GGTGGCAA	GGTGGGAA
GGNTCTGA	GGTTCTGA
GGNTCTGC	GGGTCTGC
GGACATAG	GGCATAGA
GGTGGCTT	GTGGCTTC
GTCAACCT	GTCCACCT
GNAAGCTA	GAAGCTAG
GCTGGCTT	GTGGCTTC
GGNTCGTA	GGGTCGTA
GGTGGCGA	GGTGGGAA
GAGCGTAT	AGCGTATC
GTCAACGG	GCAACGGC
GGTGGTAA	GGTGGGAA
GAGGCTAG	GAAGCTAG
GTAGTAAC	TTAGTAAC
GGTNCTGA	GGTTCTGA
NAACCTAA	CAACCTAA
NCTAAACG	ACTAAACG
GTCAATAC	GCAATACT
GAGGCTTC	GTGGCTTC
GATACTAT	GATAATAT
GCTGGTGA	GCGGGTGA
GNGGCTTC	GTGGCTTC
GATACTTG	GATATTGG
GCTGGGAA	GGTGGGAA
GGTGGTGA	GGTGGGAA
GNATAATA	GATAATAT
GATACTGG	GATATTGG
GCTGGGTG	GCGGGTGA
NCTAACAG	CCTAACAG
GGTGGGAA	GGTGGGAA
GGTGGGAC	GGTGGGAA
GGTGGGAT	GGTGGGAA
GGTGGGAG	GGTGGGAA
GGTGGGAN	GGTGGGAA
GGTGGGCA	GGTGGGAA
GATACGCA	GAACGCAT
GGTGGGTA	GGTGGGAA
GNTCTTTG	GTCTTTGG
NAACTCAG	AACTCAGT
GGNTTCTG	GGTTCTGA
GNGCGATC	GTGCGATC
GTGNGATC	GTGCGATC
GTCACACC	GTCCACCT
NAGTCAGT	AGTCAGTT
GGTGGGGA	GGTGGGAA
NCACTCTC	CACTCTCG
GGTGGGNA	GGTGGGAA
GGTNTAAC	GGTATAAC
GTGNGCTT	GTGGCTTC
GNGGTCTG	GGGTCTGC
GGTGGNAA	GGTGGGAA
GNGGTCGT	GGGTCGTA
GTCACCTA	GTCCACCT
GTCACCTC	GTCCACCT
GTCACCTT	GTCCACCT
GTCACCTG	GTCCACCT
GTCACCTN	GTCCACCT
GNATATTG	GATATTGG
GGTGGNGA	GGTGGGAA
GATATAAC	GGTATAAC
GNGCGAGA	GGCGAGAC
GATATATA	GATAATAT
GATATATC	GATAATAT
GATATATT	GATAATAT
GATATATN	GATAATAT
GAGGTCTG	GGGTCTGC
GATATAGG	GATATTGG
GAGGTCGT	GGGTCGTA
GGTNTCTG	GGTTCTGA
GNGGGATC	GGGGATCC
NACAGCCG	ACAGCCGG
GATATCTG	GATATTGG
GGGTACAA	GGGATACA
GGGTACAC	GGGATACA
GGGTACAT	GGGATACA
GATATCGG	GATATTGG
GGGTACAG	GGGATACA
GGGTACAN	GGGATACA
GGGTACTG	GGGTCTGC
GATATTAT	GATAATAT
GTAGGCTT	GTGGCTTC
NAACGCAT	GAACGCAT
GATATTAG	GATATTGG
GGNCTAGT	GGCTAGTT
GGGTACGT	GGGTCGTA
GNGGGTGA	GCGGGTGA
GATATTCG	GATATTGG
NCACTGTT	CACTGTTT
GGGTATAA	GGTATAAC
GGGTATAC	GGGATACA
GATATTTG	GATATTGG
GGGTATCC	GGGGATCC
GGGTATGC	GGGTCTGC
NAAGCACC	AAGCACCC
GGTGNGAA	GGTGGGAA
GATATTGA	GATATTGG
GATATTGC	GATATTGG
GATATTGT	GATATTGG
GATATTGG	GATATTGG
GATATTGN	GATATTGG
GGGTAGTA	GGGTCGTA
GGGTAGTT	GGCTAGTT
NCCCCGGC	CCCCGGCA
GATATTNG	GATATTGG
GGTGNGGA	GGTGGGAA
GATATGTG	GATATTGG
NAACGTTT	AACGTTTA
GATATGGA	GATATTGG
GNCAACGG	GCAACGGC
GATATGGC	GATATTGG
GATATGGT	GATATTGG
GNCAATAC	GCAATACT
GATATGGG	GATATTGG
GATATGGN	GATATTGG
NAAGCTAG	GAAGCTAG
NATGTCGT	AATGTCGT
NAAGCTCG	AAAGCTCG
GATATNTG	GATATTGG
NATGTTGT	AATGTTGT
GGGTCATA	GGGTCGTA
GATATNGG	GATATTGG
GGTANAAC	GGTATAAC
NCTACTCG	CTACTCGT
NCAAAGTC	CCAAAGTC
NTTAAAAT	TTAAAATA
NAGTTGCC	AGTTGCCT
GGGTCATG	GGGTCTGC
GGGTCAGC	GGGTCTGC
GGGTCAGT	GGGTCGTA
NGTATAAC	GGTATAAC
GGGGNATC	GGGGATCC
GGNTGGGA	GGTGGGAA
GGGTCCTA	GGGTCGTA
GGGTCCTG	GGGTCTGC
GGGTCCGC	GGGTCTGC
GGGTCCGT	GGGTCGTA
GGTANTAA	GGTATAAC
NCAACCTA	CAACCTAA
GGGTCTAA	GGGTCGTA
GGGTCTAT	GGGTCGTA
GGGTCTAN	GGGTCGTA
GGGTCTCA	GGGTCTGC
GGGTCTCC	GGGTCTGC
GGGTCTCT	GGGTCTGC
GGGTCTCG	GGGTCTGC
GGGTCTCN	GGGTCTGC
GGGTCTTA	GGGTCGTA
GGGTCTTC	GGGTCTGC
GGGTCTTG	GGGTCTGC
GGGTCTGC	GGGTCTGC
GGGTCTGG	GGGTCTGC
GGGTCTGN	GGGTCTGC
GGGTCTNC	GGGTCTGC
GGGTCTNG	GGGTCTGC
GGGTCGAA	GGGTCGTA
GGGTCGAC	GGGTCGTA
GGGTCGAT	GGGTCGTA
GGGTCGAG	GGGTCGTA
GGGTCGAN	GGGTCGTA
GGGTCGCC	GGGTCTGC
GGGTCGCG	GGGTCTGC
GGGTCGCN	GGGTCTGC
GGGTCGTA	GGGTCGTA
GGGTCGTC	GGGTCGTA
GGGTCGTT	GGGTCGTA
NAGAGCAG	TAGAGCAG
GGGTCGTN	GGGTCGTA
GGGTCGGA	GGGTCGTA
GGGTCGGC	GGGTCTGC
GGGTCGGT	GGGTCGTA
GNTAATAT	GATAATAT
GGGTCGNA	GGGTCGTA
NAGAGCTT	CAGAGCTT
GGGTCGNT	GGGTCGTA
GGNCGAGA	GGCGAGAC
NAGAGCGC	AGAGCGCG
NCAACGGC	GCAACGGC
GGGTCNTA	GGGTCGTA
GGGTCNTG	GGGTCTGC
GGGTCNGC	GGGTCTGC
GGGTCNGT	GGGTCGTA
GGGGNTCC	GGGGATCC
GNGTATAA	GGTATAAC
GNCATAGA	GGCATAGA
GNCTAGTT	GGCTAGTT
NTTACAGG	ATTACAGG
NTTACCCT	TTTACCCT
NCAATACT	GCAATACT
GGTNGGAA	GGTGGGAA
GGGTTACA	GGGATACA
GGTNGGGA	GGTGGGAA
NCCCGGCA	CCCCGGCA
GNTTCTAC	GTTCTACG
NAAAAATC	TAAAAATC
GNACCCTC	GACCCTCA
GNTTCTGA	GGTTCTGA
GGGTTCGT	GGGTCGTA
NCATATGC	CCATATGC
GGNGATAC	GGGATACA
GGTCATAA	GGTATAAC
NAGCACCC	AAGCACCC
GGTCATAG	GGCATAGA
NAATAAGA	AATAAGAA
GGNGATCC	GGGGATCC
GGGTTTGC	GGGTCTGC
GGGNATAC	GGGATACA
GGNGAGAC	GGCGAGAC
GGGNATCC	GGGGATCC
NCTTCCAT	ACTTCCAT
GGGTTGCA	GGGTCTGC
GGGTTGCC	GGGTCTGC
GGGTTGCT	GGGTCTGC
GGGTTGCG	GGGTCTGC
GGGTTGCN	GGGTCTGC
GGGTTGTA	GGGTCGTA
GNGTCTGC	GGGTCTGC
GGTCAGTT	AGTCAGTT
GNGTCGTA	GGGTCGTA
NCTAGGAA	CCTAGGAA
GNCTTTAC	GCCTTTAC
NACCCTCA	GACCCTCA
NAAGGGGC	TAAGGGGC
GNCTTTTT	GCTTTTTA
GNCTTTGG	GTCTTTGG
GGGTGATC	GGGGATCC
GNTTTTTA	GCTTTTTA
GGGTGAGG	TGGTGAGG
GGGTGCTG	GGGTCTGC
GGGTGCGT	GGGTCGTA
GGGTGTAA	GGGTCGTA
GGGTGTAC	GGGTCGTA
NAGGCCCG	CAGGCCCG
NAGCCCGC	AGCCCGCG
NCATCGGT	CATCGGTC
GGGAAACA	GGGATACA
GGGNCTGC	GGGTCTGC
GGGTGTAT	GGGTCGTA
GGGTGTAG	GGGTCGTA
GGGTGTAN	GGGTCGTA
GGGTGTGC	GGGTCTGC
GGTCCACC	GTCCACCT
GGGTGGTA	GGGTCGTA
GGGAACAA	GGGATACA
GGGAACAC	GGGATACA
GNGTTCTG	GGTTCTGA
NTTAGTAA	TTAGTAAC
NAGCCGTT	AGCCGTTC
GGGTGGGA	GGTGGGAA
NCCTAACA	CCTAACAG
NCTTTTTA	GCTTTTTA
GGGAACAT	GGGATACA
GGGAACAG	GGGATACA
GGGAACAN	GGGATACA
GGGNCGTA	GGGTCGTA
GNTATAAC	GGTATAAC
GNACGCAT	GAACGCAT
GGGTNCTG	GGGTCTGC
NCTTTGGC	CTTTGGCT
GGGTNCGT	GGGTCGTA
NGGGGATC	GGGGATCC
GGGAATAC	GGGATACA
GGGAATCC	GGGGATCC
GGGTNTGC	GGGTCTGC
GGGTNGTA	GGGTCGTA
GGTCCTGA	GGTTCTGA
GGGGAACC	GGGGATCC
GGGGAATC	GGGGATCC
GGGNTACA	GGGATACA
GNTATTGG	GATATTGG
NATCGGTC	CATCGGTC
GGGNTCTG	GGGTCTGC
GGGNTCGT	GGGTCGTA
NACCTTGG	ACCTTGGT
GGGGACCA	GGGGATCC
GGGGACCC	GGGGATCC
GGGGACCT	GGGGATCC
GGGGACCG	GGGGATCC
GGGGACCN	GGGGATCC
GGGGACTC	GGGGATCC
GNGTGGGA	GGTGGGAA
NCGAAGGG	ACGAAGGG
GGGGATCA	GGGGATCC
GGGGATCC	GGGGATCC
GGGGATCT	GGGGATCC
GGGGATCG	GGGGATCC
GGGGATCN	GGGGATCC
GGGGATTC	GGGGATCC
GGTCCGGG	CGTCCGGG
NAAATGAC	TAAATGAC
NCCTAGGA	CCTAGGAA
GGGGATGC	GGGGATCC
GGGGATNC	GGGGATCC
GGGGAGAC	GGCGAGAC
GGGGAGCC	GGGGATCC
GGGGAGTC	GGGGATCC
GGGACACA	GGGATACA
GGGGANCC	GGGGATCC
GGGGANTC	GGGGATCC
GNCCACCT	GTCCACCT
GGTCTAAC	GGTATAAC
GGGGCATC	GGGGATCC
NAAAGATT	TAAAGATT
NAGAAATG	AGAAATGC
GGTCTACG	GTTCTACG
GNAGCTAG	GAAGCTAG
GGGACTAC	GGGATACA
GGNGTCTG	GGGTCTGC
GGTCTAGT	GGCTAGTT
GGNGTCGT	GGGTCGTA
NTGGATCA	TGGATCAA
NCGGACTT	TCGGACTT
GGGNGATC	GGGGATCC
NAAAGCTC	AAAGCTCG
NCGACTTG	CCGACTTG
GGGGCTCC	GGGGATCC
GGGGCTTC	GTGGCTTC
GGGGCTGC	GGGTCTGC
GGTCTCTG	GGTTCTGA
GGGGCGTA	GGGTCGTA
GGGACTGC	GGGTCTGC
NTTCAAAA	TTCAAAAG
GGGACGTA	GGGTCGTA
NCACAATG	ACACAATG
NAGCGTAT	AGCGTATC
GGTCTTTG	GTCTTTGG
NTGGCCAA	CTGGCCAA
GGTCTGAA	GGTTCTGA
GGTCTGAC	GGTTCTGA
GGTCTGAT	GGTTCTGA
GGTCTGAG	GGTTCTGA
GGTCTGAN	GGTTCTGA
GGTCTGCA	GGGTCTGC
GGTCTGCC	GGGTCTGC
GGTCTGCT	GGGTCTGC
GGTCTGCG	GGGTCTGC
GGTCTGCN	GGGTCTGC
GGGATAAA	GGGATACA
GGGGTACA	GGGATACA
GGGGTATC	GGGGATCC
GGGATAAT	GGGATACA
GGGATAAG	GGGATACA
GGGATAAN	GGGATACA
GGGATACA	GGGATACA
GGGATACC	GGGATACA
GGGATACT	GGGATACA
GGGATACG	GGGATACA
GGGATACN	GGGATACA
NTGGCTTC	GTGGCTTC
GGGATATA	GGGATACA
GGGATATC	GGGATACA
GGGATAGC	GGGATACA
GGGATANA	GGGATACA
GGGATANC	GGGATACA
NGGATACA	GGGATACA
NCGGCCCA	CGGCCCAT
GGGGTCCA	GGGGATCC
GGGGTCCC	GGGGATCC
GGGGTCCT	GGGGATCC
GGGGTCCG	GGGGATCC
GGGGTCCN	GGGGATCC
NATAATAT	GATAATAT
GGGGTCTG	GGGTCTGC
GGGGTCGT	GGGTCGTA
GNCCCTCA	GACCCTCA
NGGATCAA	TGGATCAA
GGGATCAC	GGGATACA
GGGATCAT	GGGATACA
GGGATCAG	GGGATACA
GGGATCAN	GGGATACA
GGGATCCC	GGGGATCC
GGGATCCT	GGGGATCC
GGGATCCG	GGGGATCC
GGGATCCN	GGGGATCC
GGGATCTG	GGGTCTGC
GGGATCGT	GGGTCGTA
GGGGTTCC	GGGGATCC
NATAAGAA	AATAAGAA
GGTCGAGA	GGCGAGAC
GGGGTGAA	GCGGGTGA
GGGGTGAC	GCGGGTGA
GGGGTGAT	GCGGGTGA
GGGGTGAG	GCGGGTGA
GNGATACA	GGGATACA
GGGGTGAN	GCGGGTGA
GGGATTAC	GGGATACA
NCCTTTAC	GCCTTTAC
NGTTCTAC	GTTCTACG
GGGATTCA	GGGATACA
NGTTCTGA	GGTTCTGA
GGGATGAC	GGGATACA
NACACAAT	ACACAATG
GGGATGCA	GGGATACA
NCCTTGGT	ACCTTGGT
NTAAGGGG	TAAGGGGC
NTTCCTCC	ATTCCTCC
NTGGTGAG	TGGTGAGG
NTGACCCT	TGACCCTT
GNCCTTTA	GCCTTTAC
GGTCGTAA	GGGTCGTA
GGTCGTAC	GGGTCGTA
GGTCGTAT	GGGTCGTA
GGTCGTAG	GGGTCGTA
NGGTATAA	GGTATAAC
GGTCGTAN	GGGTCGTA
GGGATNAC	GGGATACA
GNCGAGAC	GGCGAGAC
GGGATNCA	GGGATACA
GGGGGAAA	GGTGGGAA
GGGGGAAC	GGTGGGAA
GGGGGAAT	GGTGGGAA
GGGGGAAG	GGTGGGAA
GGGGGAAN	GGTGGGAA
NGAGACTA	TGAGACTA
GGGGGATC	GGGGATCC
NGAAATGC	AGAAATGC
NACTAAAC	ACTAAACG
GGTCGGAA	GGTGGGAA
GGTCGGGA	GGTGGGAA
GGGGGTCC	GGGGATCC
NTTCTACG	GTTCTACG
GGGGGTGA	GCGGGTGA
NGCAACGG	GCAACGGC
NTGATAAC	TGATAACC
GGGGGGAA	GGTGGGAA
NGCAATAC	GCAATACT
NGACCCTC	GACCCTCA
NGACCCTT	TGACCCTT
NGAACGCA	GAACGCAT
NCGGGACC	TCGGGACC
NTCGGACT	TCGGACTT
NCGCACGA	CGCACGAC
NGTAGAAA	CGTAGAAA
NGCACGAC	CGCACGAC
NGGTCTGC	GGGTCTGC
NACATGGA	TACATGGA
NTCGGGAC	TCGGGACC
NGGTCGTA	GGGTCGTA
NCGGGTGA	GCGGGTGA
GNGCATAG	GGCATAGA
GNTCCACC	GTCCACCT
NTCCACCT	GTCCACCT
NGCATAGA	GGCATAGA
NGTTGCCT	AGTTGCCT
NTACATGG	TACATGGA
NTTGTGGG	TTGTGGGC
NGCTTTTT	GCTTTTTA
NGGTTCTG	GGTTCTGA
NGAAGCTA	GAAGCTAG
NGAGCGCG	AGAGCGCG
GGTTAACA	GGTATAAC
GGTTAACC	GGTATAAC
GGTTAACT	GGTATAAC
GGTTAACG	GGTATAAC
GGTTAACN	GGTATAAC
GGTTACTG	GGTTCTGA
NTGAGACT	TGAGACTA
GGTTATAA	GGTATAAC
NGGCATAG	GGCATAGA
NTGCGATC	GTGCGATC
NTCTTTGG	GTCTTTGG
GGTTATGA	GGTTCTGA
NTCCCATG	TCCCATGC
NGGTGAGG	TGGTGAGG
NTCTGAAA	TCTGAAAG
GGTTAGTT	GGCTAGTT
NGCCCGCG	AGCCCGCG
NTCTGGAA	TCTGGAAC
NCGCTGGC	TCGCTGGC
GGTTCATG	GGTTCTGA
GGTTCAGA	GGTTCTGA
NGGTGGGA	GGTGGGAA
NTACTCGT	CTACTCGT
NTTTACCC	TTTACCCT
NGCCTTTA	GCCTTTAC
GGTTCCTG	GGTTCTGA
GGTTCCGA	GGTTCTGA
NGATAACC	TGATAACC
NGATAATA	GATAATAT
GGTTCTAA	GGTTCTGA
NTAAAAAT	TAAAAATC
GGTTCTAT	GGTTCTGA
NGTCAGTT	AGTCAGTT
GGTTCTAG	GGTTCTGA
GGTTCTAN	GGTTCTGA
GGTTCTCA	GGTTCTGA
GGTTCTCG	GGTTCTGA
GGTTCTTA	GGTTCTGA
NGGCCCAT	CGGCCCAT
NTAAAATA	TTAAAATA
GGTTCTTG	GGTTCTGA
GGTTCTGA	GGTTCTGA
GGTTCTGT	GGTTCTGA
GGTTCTGG	GGTTCTGA
GGTTCTGN	GGTTCTGA
GGTTCTNA	GGTTCTGA
GGTTCTNG	GGTTCTGA
GGTTCGAA	GGTTCTGA
GGTTCGAC	GGTTCTGA
GGTTCGAT	GGTTCTGA
GGTTCGAG	GGTTCTGA
GGTTCGAN	GGTTCTGA
NGTCCACC	GTCCACCT
NGATATTG	GATATTGG
NTAGAGCA	TAGAGCAG
GGTTCGTA	GGGTCGTA
GGTTCGTG	GGTTCTGA
GGTTCGGA	GGTTCTGA
NTAAATGA	TAAATGAC
NTAAAGAT	TAAAGATT
NGCCGTTC	AGCCGTTC
GGTTCNTG	GGTTCTGA
GGTTCNGA	GGTTCTGA
NTCAAAAG	TTCAAAAG
NTAGTAAC	TTAGTAAC
NGGCTAGT	GGCTAGTT
NGTGCGAT	GTGCGATC
NTGTGCCA	CTGTGCCA
NGTCCGGG	CGTCCGGG
NGGGATAC	GGGATACA
NGGGATCC	GGGGATCC
NGCGAGAC	GGCGAGAC
NCGTAGAA	CGTAGAAA
NTCGCTGG	TCGCTGGC
NTGTGGGC	TTGTGGGC
NTTTGGCT	CTTTGGCT
NGTCTTTG	GTCTTTGG
NGCTAGTT	GGCTAGTT
NGGCGAGA	GGCGAGAC
NCGTCCGG	CGTCCGGG
NCTGAAAG	TCTGAAAG
NCTGAGGA	ACTGAGGA
NGCGTATC	AGCGTATC
NGTGGCTT	GTGGCTTC
NGGGTCTG	GGGTCTGC
NGGGTCGT	GGGTCGTA
NGTGGGAA	GGTGGGAA
NGCGGGTG	GCGGGTGA
NCTGTGCC	CTGTGCCA
NCTGGAAC	TCTGGAAC
NCTGGCCA	CTGGCCAA
