AAACTAAA	AAACTAAC
AAACTAAC	AAACTAAC
AAACTAAG	AAACTAAC
AACCGAAC	ACCCGAAC
AAACTAAT	AAACTAAC
AAACTAAN	AAACTAAC
AAACTACA	AAACTAAC
AAACTACC	AAACTAAC
AACTAACA	AAACTAAC
AAACTACG	AAACTAAC
AACTAACC	AAACTAAC
AAACTACT	AAACTAAC
AACTAACG	AAACTAAC
AAACTACN	AAACTAAC
AAACTAGA	AAACTAAC
AACTAACT	AAACTAAC
AAACTAGC	AAACTAAC
AACTAACN	AAACTAAC
AACTAAGC	ACTAAGCG
AAAAAATG	AAAACATG
AAACTATA	AAACTAAC
AAATCATG	AAAACATG
AAACTATC	AAACTAAC
AAACTANA	AAACTAAC
AAACTANC	AAACTAAC
AAAAACAT	AAAACATG
AAACTCAA	AAACTAAC
AAACTCAC	AAACTAAC
AAAAACCC	AAAATCCC
AAATCCCA	AAAATCCC
AAATCCCC	AAAATCCC
AAATCCCG	AAAATCCC
AAACTCCC	AAAATCCC
AAATCCCT	AAAATCCC
AACCGCCA	ATCCGCCA
AAATCCCN	AAAATCCC
AACCGCTG	AACCCTGG
AAACTGAA	AAACTAAC
AAACTGAC	AAACTAAC
AAGCCCTG	AACCCTGG
AAATCGTA	AAATGTAG
AAACTGTA	AAATGTAG
AAATCGTT	AAACGTTC
AAACTGTT	AAACGTTC
AACTAGCT	AATAGCTT
AAATCTAA	AAACTAAC
AAAAATCC	AAAATCCC
AAACTTAA	AAACTAAC
AAACTTAC	AAACTAAC
AAATCTAG	AAATGTAG
AAAAATGA	AAAACATG
AAAAATGC	AAAACATG
AAACTTCA	AAACGTTC
AAAAATGG	AAAACATG
AAACTTCC	AAACGTTC
AAAAATGT	AAAACATG
AACTAGTT	CACTAGTT
AAACTTCG	AAACGTTC
AAAAATGN	AAAACATG
AAACTTCT	AAACGTTC
AAACTTCN	AAACGTTC
AAAAATTT	GAAAATTT
AAACTTTC	AAACGTTC
AACCGTGG	AACCCTGG
AACCGTTC	AAACGTTC
AAACTNAA	AAACTAAC
AAACTNAC	AAACTAAC
AAGCCTGG	AACCCTGG
AAAACAAG	AAAACATG
AAAACAAT	AAAACATG
AAAACACG	AAAACATG
AAAACACT	AAAACATG
AAACNAAC	AAACTAAC
AAATGAAG	AAATGTAG
AAAACAGA	AAAACATG
AAAACAGC	AAAACATG
AAAACAGG	AAAACATG
AAAACAGT	AAAACATG
AAATGACC	AATGACCG
AAAACAGN	AAAACATG
AAAACATA	AAAACATG
AAAACATC	AAAACATG
AAAACATG	AAAACATG
AAATGAGA	AAATGTAG
AAAACATT	AAAACATG
AAATGAGC	AAATGTAG
AACCTAAC	AAACTAAC
AAAACATN	AAAACATG
AAATGAGG	AAATGTAG
AAATGAGT	AAATGTAG
AAATGAGN	AAATGTAG
AAAACANG	AAAACATG
AAATGATA	AAATGTAG
AAAACANT	AAAACATG
AAAACCAT	AAAACATG
AAAACCCA	AAAATCCC
AAAACCCC	AAAATCCC
AAAACCCG	AAAATCCC
AAAACCCT	AAAATCCC
AAAACCCN	AAAATCCC
AAATGCAG	AAATGTAG
AACAAAGG	AGCAAAGG
AAAACCTG	AAAACATG
AAATGCTA	AAATGTAG
AAAACGAT	AAAACATG
AACAACAT	AAAACATG
AAATGGAG	AAATGTAG
AACCTCTG	AACCCTGG
AAAACGTG	AAAACATG
AAAACGTT	AAACGTTC
AACTCCTG	AACCCTGG
AAATGGTA	AAATGTAG
AAAACTAA	AAACTAAC
AAACNGTT	AAACGTTC
AAAACTAT	AAAACATG
AAAACTCC	AAAATCCC
AACCTGGA	AACCCTGG
AAATGTAA	AAATGTAG
AACCTGGC	AACCCTGG
AAACNTAA	AAACTAAC
AAATGTAC	AAATGTAG
AACCTGGG	AACCCTGG
AAAACTGA	AAAACATG
AAATGTAG	AAATGTAG
AACCTGGT	AACCCTGG
AAAACTGC	AAAACATG
AAATGTAT	AAATGTAG
AACCTGGN	AACCCTGG
AAAACTGG	AAAACATG
AAATGTAN	AAATGTAG
AAAACTGT	AAAACATG
AAATGTCA	AAATGTAG
AAAACTGN	AAAACATG
AAATGTCG	AAATGTAG
AAAACTTG	AAAACATG
AAATGTGA	AAATGTAG
AAATGTGC	AAATGTAG
AAATGTGG	AAATGTAG
AAATGTGT	AAATGTAG
AAATGTGN	AAATGTAG
AAATGTTA	AAATGTAG
AAACNTTC	AAACGTTC
AAATGTTC	AAACGTTC
AAATGTTG	AAATGTAG
AAAACNAT	AAAACATG
AAATGTNA	AAATGTAG
AACCTTCG	CACCTTCG
AAATGTNG	AAATGTAG
AACCTTGG	AACCCTGG
AAATGNAG	AAATGTAG
AACAATCC	AAAATCCC
AACTCTGG	AACCCTGG
AAAACNTG	AAAACATG
AAATGNTA	AAATGTAG
AAGCGTTC	AAACGTTC
AAATTAAC	AAACTAAC
AAATTACA	TAATTACA
AAAAGATG	AAAACATG
AAATTAGA	AAATGTAG
AAATTAGC	AAATGTAG
AAATTAGG	AAATGTAG
AAATTAGT	AAATGTAG
AAATTAGN	AAATGTAG
AAAAGCAT	AAAACATG
AAAAGCCC	AAAATCCC
AAAGACAT	AAAACATG
AACTGACC	AATGACCG
AAAGACCG	AATGACCG
AAAAGCTT	AATAGCTT
AAATTCCC	AAAATCCC
AAGAACAT	AAAACATG
AAGCTAAC	AAACTAAC
AAATTCGT	GAATTCGT
AACACATG	AAAACATG
AAATTGCG	AAGTTGCG
AACCNCTG	AACCCTGG
AAATTGGA	CAAATTGG
AAATTGGC	CAAATTGG
AAATTGGG	CAAATTGG
AAATTGGT	CAAATTGG
AAAAGTAG	AAATGTAG
AAATTGGN	CAAATTGG
AAATTGTA	AAATGTAG
AAAAGTCC	AAAATCCC
AAAAGTTC	AAACGTTC
AAAGATCC	AAAATCCC
AAAGATCG	TAAGATCG
AACACCTG	AACCCTGG
AAGAATCC	AAAATCCC
AACTGTAG	AAATGTAG
AACCNTGG	AACCCTGG
AAAATAAC	AAACTAAC
AAATTTAG	AAATGTAG
AAAATACC	AAAATCCC
AACACGTT	AAACGTTC
AAGCTGCG	AAGTTGCG
AAAATATG	AAAACATG
AACACTAA	AAACTAAC
AAAATCAC	AAAATCCC
AAAATCAT	AAAACATG
AAAATCCA	AAAATCCC
AAAGCATG	AAAACATG
AAAATCCC	AAAATCCC
AAAATCCG	AAAATCCC
AAAATCCT	AAAATCCC
AAAATCCN	AAAATCCC
AAAATCGC	AAAATCCC
AAGACATG	AAAACATG
AAAATCTC	AAAATCCC
AAAATCNC	AAAATCCC
AACACTGG	AACCCTGG
AAGACCGA	AATGACCG
AAGACCGC	AATGACCG
AAGACCGG	AATGACCG
AAAATGCC	AAAATCCC
AAGACCGT	AATGACCG
AAGCTTAA	AGGCTTAA
AAGACCGN	AATGACCG
AAAATGTA	AAATGTAG
AAGCTTCT	AGCTTCTT
AAGCTTGC	AAGTTGCG
AACGACCG	AATGACCG
AAAATTCC	AAAATCCC
AAAGCGTT	AAACGTTC
AACGACTT	ATCGACTT
AAAATTGG	CAAATTGG
AAAGCTAA	AAACTAAC
AAGACGTT	AAACGTTC
AAAATTTA	GAAAATTT
AAAATTTC	GAAAATTT
AAAATTTG	GAAAATTT
AAAATTTT	GAAAATTT
AAAATTTN	GAAAATTT
AAGACTAA	AAACTAAC
AACTTCTT	AGCTTCTT
AAAGCTTA	AATAGCTT
AAAATNCC	AAAATCCC
AAAGCTTC	AATAGCTT
AAAGCTTG	AATAGCTT
AAAGCTTT	AATAGCTT
AAATNGTA	AAATGTAG
AAAGCTTN	AATAGCTT
AACTTGCG	AAGTTGCG
AACGATAC	ACGATACG
AAATNTAG	AAATGTAG
AAAANATG	AAAACATG
AAAGGACT	ACAGGACT
AAAANCAT	AAAACATG
AAAANCCC	AAAATCCC
AAAGGCCG	AGAGGCCG
AACAGCTT	AATAGCTT
AAGAGCTT	AATAGCTT
AACAGGAC	ACAGGACT
AAANACAT	AAAACATG
AAGAGGCC	AGAGGCCG
AACGCCCA	TACGCCCA
AAAGGGTA	GAAGGGTA
AAAANTCC	AAAATCCC
AACGCCTG	AACCCTGG
AAAGGTAG	AAATGTAG
AAAGGTCC	CAAGGTCC
AAAGGTTC	AAACGTTC
AAANATCC	AAAATCCC
AAACAAAC	AAACTAAC
AACGCTGG	AACCCTGG
AAACAACA	AAACTAAC
AAACAACC	AAACTAAC
AAACAACG	AAACTAAC
AAACAACT	AAACTAAC
AAACAACN	AAACTAAC
AAAGTAAC	AAACTAAC
AAAGTAGA	AAATGTAG
AAAGTAGC	AAATGTAG
AAAGTAGG	AAATGTAG
AAAGTAGT	AAATGTAG
AAGATAAT	CAGATAAT
AAAGTAGN	AAATGTAG
AAGATACG	ACGATACG
AAACACAT	AAAACATG
AACGGAAA	ATCGGAAA
AAAGTCCC	AAAATCCC
AAANCATG	AAAACATG
AACATCCC	AAAATCCC
AAGATCCC	AAAATCCC
AAGATCGA	TAAGATCG
AAGATCGC	TAAGATCG
AAGATCGG	TAAGATCG
AAGATCGT	TAAGATCG
AAGATCGN	TAAGATCG
AAAGTGTA	AAATGTAG
AAACAGTT	AAACGTTC
AAACATAA	AAACTAAC
AACATGTA	AAATGTAG
AAGATGCG	AAGTTGCG
AAACATCC	AAAATCCC
AAAGTTCA	AAACGTTC
AAAGTTCC	AAACGTTC
AAAGTTCG	AAACGTTC
AAAGTTCT	AAACGTTC
AAAGTTCN	AAACGTTC
AAACATGA	AAAACATG
AAGGACCG	AATGACCG
AAANCGTT	AAACGTTC
AAACATGC	AAAACATG
AAGATGTA	AAATGTAG
AAAGTTGC	AAGTTGCG
AAACATGG	AAAACATG
AACATTAT	GACATTAT
AAACATGT	AAAACATG
AAACATGN	AAAACATG
AAACATTC	AAACGTTC
AAGGACTA	ACAGGACT
AAANCTAA	AAACTAAC
AAGGACTC	ACAGGACT
AAGGACTG	ACAGGACT
AAGGACTT	ACAGGACT
AAGGACTN	ACAGGACT
AACGGTAT	TACGGTAT
AAGATTGC	AAGTTGCG
AAACCAAC	AAACTAAC
AAACCAGC	TAACCAGC
AAACCATG	AAAACATG
AAACCCTG	AACCCTGG
AAACCGTT	AAACGTTC
AAGGCCGA	AGAGGCCG
AAGGCCGC	AGAGGCCG
AAGGCCGG	AGAGGCCG
AAGGCCGT	AGAGGCCG
AAGGCCGN	AGAGGCCG
AAACCTAA	AAACTAAC
AAANGTAG	AAATGTAG
AACNCCTG	AACCCTGG
AAACCTGG	AACCCTGG
AAANGTTC	AAACGTTC
AAACCTTC	AAACGTTC
AACGTTCA	AAACGTTC
AACGTTCC	AAACGTTC
AACGTTCG	AAACGTTC
AACGTTCT	AAACGTTC
AACGTTCN	AAACGTTC
AACGTTGC	AAGTTGCG
AAATAACA	AAACTAAC
AAATAACC	AAACTAAC
AAATAACG	AAACTAAC
AAATAACT	AAACTAAC
AAATAACN	AAACTAAC
AACNCTGG	AACCCTGG
AAGGCTTA	AGGCTTAA
AAANTAAC	AAACTAAC
AAACGAAC	AAACTAAC
AAATACAT	AAAACATG
AAACGATC	AAACGTTC
AAACGATT	AAACGTTC
AAANTCCC	AAAATCCC
AAGCAAAG	AGCAAAGG
AAATAGCT	AATAGCTT
AACCACTG	AACCCTGG
AAATAGTA	AAATGTAG
AACCAGAG	CACCAGAG
AAACGCTC	AAACGTTC
AACCAGCA	TAACCAGC
AACCAGCC	TAACCAGC
AAACGCTT	AAACGTTC
AACCAGCG	TAACCAGC
AACCAGCT	TAACCAGC
AACCAGCN	TAACCAGC
AAATATAG	AAATGTAG
AAANTGTA	AAATGTAG
AAATATCC	AAAATCCC
AAGGGCTA	ATGGGCTA
AAACGGTC	AAACGTTC
AAACGGTT	AAACGTTC
AACCATGG	AACCCTGG
AAACGTAA	AAACTAAC
AAACGTAC	AAACGTTC
AAACGTAG	AAATGTAG
AAACGTAT	AAACGTTC
AAACGTCA	AAACGTTC
AAACGTCC	AAACGTTC
AAACGTCG	AAACGTTC
AAACGTCT	AAACGTTC
AAACGTCN	AAACGTTC
AAACGTGC	AAACGTTC
AAACGTGT	AAACGTTC
AAGGGTAA	GAAGGGTA
AAACGTTA	AAACGTTC
AAGGGTAC	GAAGGGTA
AAACGTTC	AAACGTTC
AAGGGTAG	GAAGGGTA
AAGGGTAT	GAAGGGTA
AAACGTTG	AAACGTTC
AAGGGTAN	GAAGGGTA
AAACGTTT	AAACGTTC
AAACGTTN	AAACGTTC
AAACGTNC	AAACGTTC
AAACGTNT	AAACGTTC
AATCAACC	ATTCAACC
AACCCAGG	AACCCTGG
AAACGNTC	AAACGTTC
AACCCATG	AACCCTGG
AAACGNTT	AAACGTTC
AATCACCG	AATGACCG
AACCCCGG	AACCCTGG
AACCCCTG	AACCCTGG
AACCCGAA	ACCCGAAC
AATCAGCT	AATAGCTT
AAGGTCCA	CAAGGTCC
AAGGTCCC	CAAGGTCC
AAGGTCCG	CAAGGTCC
AACCCGGA	AACCCTGG
AAGGTCCT	CAAGGTCC
AACCCGGC	AACCCTGG
AAGGTCCN	CAAGGTCC
AACCCGGG	AACCCTGG
AACCCGGT	AACCCTGG
AACCCGGN	AACCCTGG
AACCCGTC	GACCCGTC
AACCCGTG	AACCCTGG
AACCCTAG	AACCCTGG
AACCCTCG	AACCCTGG
AAGGTGCG	AAGTTGCG
AACCCTGA	AACCCTGG
AACCCTGC	AACCCTGG
AACCCTGG	AACCCTGG
AAGGTGGT	AGGTGGTT
AACCCTGT	AACCCTGG
AACCCTGN	AACCCTGG
AACCCTTG	AACCCTGG
AACCCTNG	AACCCTGG
AAGGTTGC	AAGTTGCG
AACCCNGG	AACCCTGG
AACCCNTG	AACCCTGG
AATGTACC	AATGACCG
AATGTAGA	AAATGTAG
AATGTAGC	AAATGTAG
AATGTAGG	AAATGTAG
AATGTAGT	AAATGTAG
AATGTAGN	AAATGTAG
AATNGACC	AATGACCG
AATGTCCG	AATGACCG
AATCCCTG	AACCCTGG
AAGNTGCG	AAGTTGCG
AATCCGCC	ATCCGCCA
AATNGCTT	AATAGCTT
AAGNTTGC	AAGTTGCG
AATCCTGA	ATTCCTGA
AATCCTGG	AACCCTGG
AATGTTGC	AAGTTGCG
AAGTAGCG	AAGTTGCG
AAGTAGCT	AATAGCTT
AATCGACC	AATGACCG
AATCGACT	ATCGACTT
AATGNACC	AATGACCG
AAGTATGC	AAGTTGCG
AANGTTGC	AAGTTGCG
AATGNCCG	AATGACCG
AATCGCTT	AATAGCTT
AATCGGAA	ATCGGAAA
AANCCCTG	AACCCTGG
AATCGTTC	AAACGTTC
AATCTAAC	AAACTAAC
AANCCTGG	AACCCTGG
AAGTCGCG	AAGTTGCG
AAGTCGGT	GAGTCGGT
AATAACAT	AAAACATG
AATAACCG	AATGACCG
AATCTCAG	AGTCTCAG
AATTACAA	TAATTACA
AAGTCTCA	AGTCTCAG
AATTACAC	TAATTACA
AATTACAG	TAATTACA
AATTACAT	TAATTACA
AATTACAN	TAATTACA
AATAACTT	AATAGCTT
AATTACCG	AATGACCG
AAGTCTGC	AAGTTGCG
AATAAGCG	ACTAAGCG
AATAAGCT	AATAGCTT
AATAAGGG	TATAAGGG
AATTAGCT	AATAGCTT
AATAATCC	AAAATCCC
AATTATAT	ATTATATC
AAGTGACC	AATGACCG
AAGTGCGA	AAGTTGCG
AAGTGCGC	AAGTTGCG
AANTAGCT	AATAGCTT
AAGTGCGG	AAGTTGCG
AAGTGCGT	AAGTTGCG
AAGTGCGN	AAGTTGCG
AATTCAAC	ATTCAACC
AANCGTTC	AAACGTTC
AATACATG	AAAACATG
AAGTGGCG	AAGTTGCG
AATACCGA	AATGACCG
AATACCGC	AATGACCG
AATACCGG	AATGACCG
AATACCGT	AATGACCG
AATACCGN	AATGACCG
AAGTGGTT	AGGTGGTT
AATACCTT	AATAGCTT
AANCTAAC	AAACTAAC
AAGTGTAG	AAATGTAG
AATTCCTG	ATTCCTGA
AANAACAT	AAAACATG
AATACGCT	AATAGCTT
AAGTGTGC	AAGTTGCG
AATACGTT	AAACGTTC
AATACTAA	AAACTAAC
AATTCGTA	GAATTCGT
AATTCGTC	GAATTCGT
AATTCGTG	GAATTCGT
AATTCGTT	GAATTCGT
AATTCGTN	GAATTCGT
AATACTTA	AATAGCTT
AATACTTC	AATAGCTT
AATACTTG	AATAGCTT
AATACTTT	AATAGCTT
AATACTTN	AATAGCTT
AANAATCC	AAAATCCC
AAGTTACG	AAGTTGCG
AAGTTAGC	AAGTTGCG
AATAGAAA	GATAGAAA
AATAGACC	AATGACCG
AATAGACT	AATAGCTT
AATGAACC	AATGACCG
AATGAACG	AATGACCG
AAGTTCCG	AAGTTGCG
AATAGATT	AATAGCTT
AATTGACC	AATGACCG
AAGTTCGA	AAGTTGCG
AAGTTCGC	AAGTTGCG
AAGTTCGG	AAGTTGCG
AAGTTCGT	AAGTTGCG
AAGTTCGN	AAGTTGCG
AATAGCAT	AATAGCTT
AATGACAC	AATGACCG
AATGACAG	AATGACCG
AATAGCCT	AATAGCTT
AATGACCA	AATGACCG
AATGACCC	AATGACCG
AATGACCG	AATGACCG
AATGACCT	AATGACCG
AAGTTGAC	AAGTTGCG
AATGACCN	AATGACCG
AATAGCGT	AATAGCTT
AAGTTGAG	AAGTTGCG
AATGACGA	AATGACCG
AATGACGC	AATGACCG
AATAGCTA	AATAGCTT
AANACATG	AAAACATG
AATGACGG	AATGACCG
AATAGCTC	AATAGCTT
AATGACGT	AATGACCG
AATAGCTG	AATAGCTT
AAGTTGCA	AAGTTGCG
AATGACGN	AATGACCG
AATAGCTT	AATAGCTT
AAGTTGCC	AAGTTGCG
AATAGCTN	AATAGCTT
AATGACTC	AATGACCG
AAGTTGCG	AAGTTGCG
AATGACTG	AATGACCG
AAGTTGCT	AAGTTGCG
AAGTTGCN	AAGTTGCG
AATTGCGA	AAGTTGCG
AATAGCNT	AATAGCTT
AATTGCGC	AAGTTGCG
AAGTTGGA	AAGTTGCG
AATTGCGG	AAGTTGCG
AATGACNC	AATGACCG
AAGTTGGC	AAGTTGCG
AATTGCGT	AAGTTGCG
AATGACNG	AATGACCG
AAGTTGGG	AAGTTGCG
AATTGCGN	AAGTTGCG
AAGTTGGT	AAGTTGCG
AAGTTGGN	AAGTTGCG
AATTGCTT	AATAGCTT
AAGTTGTC	AAGTTGCG
AAGTTGTG	AAGTTGCG
AATAGGCT	AATAGCTT
AATGAGCC	AATGACCG
AATGAGCG	AATGACCG
AATGAGCT	AATAGCTT
AAGTTGNC	AAGTTGCG
AAGTTGNG	AAGTTGCG
AATAGGTT	AATAGCTT
AATTGGCG	TATTGGCG
AANTGACC	AATGACCG
AAGTTTCG	AAGTTGCG
AAGTTTGC	AAGTTGCG
AATAGTCT	AATAGCTT
AATGATCC	AATGACCG
AATGATCG	AATGACCG
AATTGTAG	AAATGTAG
AANACGTT	AAACGTTC
AATAGTTA	AATAGCTT
AATAGTTC	AATAGCTT
AATAGTTG	AATAGCTT
AATAGTTT	AATAGCTT
AATAGTTN	AATAGCTT
AANACTAA	AAACTAAC
AAGTTNCG	AAGTTGCG
AAGTTNGC	AAGTTGCG
AATAGNCT	AATAGCTT
AATGANCC	AATGACCG
AATGANCG	AATGACCG
AATAGNTT	AATAGCTT
AATGCACC	AATGACCG
AATATATC	ATTATATC
AANTGTAG	AAATGTAG
AATATCCC	AAAATCCC
AATGCCCG	AATGACCG
AATGCCGA	AATGACCG
AATGCCGC	AATGACCG
AATGCCGG	AATGACCG
AATGCCGT	AATGACCG
AATTTCCC	GATTTCCC
AATGCCGN	AATGACCG
AATATCTT	AATAGCTT
ACAAACAT	AAAACATG
AATATGCT	AATAGCTT
AANAGCTT	AATAGCTT
AAGTNGCG	AAGTTGCG
AATATGTA	AAATGTAG
AATTTGCG	AAGTTGCG
ACAAAGAG	CCAAAGAG
AANGACCG	AATGACCG
ACAAAGCG	ACTAAGCG
ACAAAGGA	AGCAAAGG
ACAAAGGC	AGCAAAGG
ACAAAGGG	AGCAAAGG
ACAAAGGT	AGCAAAGG
ACAAAGGN	AGCAAAGG
AATGCTTA	AATAGCTT
AATGCTTC	AATAGCTT
AATGCTTG	AATAGCTT
AATGCTTT	AATAGCTT
AATGCTTN	AATAGCTT
AAGTNTGC	AAGTTGCG
ACAAATCC	AAAATCCC
ACAAATTG	CAAATTGG
AANTTGCG	AAGTTGCG
AATGGACC	AATGACCG
ACAACAAC	TCAACAAC
AATGGCCG	AATGACCG
ACAACATG	AAAACATG
AATGGCTT	AATAGCTT
AANATCCC	AAAATCCC
AATGGGCT	ATGGGCTA
AATANCTT	AATAGCTT
AATANGCT	AATAGCTT
AANATGTA	AAATGTAG
ACAACGTT	AAACGTTC
ACAACTAA	AAACTAAC
ACCGAACA	ACCCGAAC
ACCGAACC	ACCCGAAC
ACCGAACG	ACCCGAAC
ACCGAACT	ACCCGAAC
ACCGAACN	ACCCGAAC
ACAAGACT	ACAGGACT
AATNACCG	AATGACCG
ACCGACGG	CCGACGGA
ACAAGCGA	ACTAAGCG
ACAAGCGC	ACTAAGCG
ACCGACTT	ATCGACTT
ACAAGCGG	ACTAAGCG
ACAAGCGT	ACTAAGCG
ACAAGCGN	ACTAAGCG
ACCTTCGA	CACCTTCG
ACCTTCGC	CACCTTCG
ACCTTCGG	CACCTTCG
ACCTTCGT	CACCTTCG
ACCTTCGN	CACCTTCG
ACCTTCTT	AGCTTCTT
AATNAGCT	AATAGCTT
ACAAGGAC	ACAGGACT
ACAGCACT	ACAGGACT
ACGACACG	ACGATACG
ACAAGGTC	CAAGGTCC
ACCGATAC	ACGATACG
ACCAGAAC	ACCCGAAC
ACGACGGA	CCGACGGA
ACCAGAGA	CACCAGAG
ACCAGAGC	CACCAGAG
ACCAGAGG	CACCAGAG
ACCAGAGT	CACCAGAG
ACCAGAGN	CACCAGAG
ACGACTAC	ACGATACG
ACCGCCAA	ATCCGCCA
ACCGCCAC	ATCCGCCA
ACCGCCAG	ATCCGCCA
ACCGCCAT	ATCCGCCA
ACCGCCAN	ATCCGCCA
ACCGCCCT	CCGCCCTA
ACGACTTA	ATCGACTT
ACGACTTC	ATCGACTT
ACGACTTG	ATCGACTT
ACGACTTT	ATCGACTT
ACAATACG	ACGATACG
ACGACTTN	ATCGACTT
ACCAGGAC	ACAGGACT
ACCGCGAA	ACCCGAAC
ACAATCCC	AAAATCCC
ACGAGACG	ACGATACG
ACAGCGAC	ACAGGACT
ACAATGTA	AAATGTAG
ACCGGAAA	ATCGGAAA
ACGAGGAC	ACAGGACT
ACCGGAAC	ACCCGAAC
ACCATACG	ACGATACG
ACGGAAAA	ATCGGAAA
ACGAGGCC	AGAGGCCG
ACGGAAAC	ATCGGAAA
ACGGAAAG	ATCGGAAA
ACCGGACT	ACAGGACT
ACGGAAAT	ATCGGAAA
ACGGAAAN	ATCGGAAA
ACGAGTAC	ACGATACG
ACGAGTCC	TCGAGTCC
ACGAGTTT	CGAGTTTA
ACGGACTA	ACAGGACT
ACGGACTC	ACAGGACT
ACGGACTG	ACAGGACT
ACGGACTT	ACAGGACT
ACGGACTN	ACAGGACT
ACCGGGCG	CCGGGCGT
ACAGGAAC	ACAGGACT
ACAGGAAT	ACAGGACT
ACAGGACA	ACAGGACT
ACAGGACC	ACAGGACT
ACAGGACG	ACAGGACT
ACAGGACT	ACAGGACT
ACAGGACN	ACAGGACT
ACAGGAGC	ACAGGACT
ACAGGAGT	ACAGGACT
ACAGGATA	ACAGGACT
ACAGGATC	ACAGGACT
ACAGGATG	ACAGGACT
ACAGGATT	ACAGGACT
ACGATAAC	ACGATACG
ACAGGATN	ACAGGACT
ACGATAAG	ACGATACG
ACAGGANC	ACAGGACT
ACGATACA	ACGATACG
ACGATACC	ACGATACG
ACAGGANT	ACAGGACT
ACGGATAC	ACGATACG
ACGATACG	ACGATACG
ACGATACT	ACGATACG
ACGATACN	ACGATACG
ACAGGCAC	ACAGGACT
ACGATAGA	ACGATACG
ACCATTGT	CCATTGTC
ACGATAGC	ACGATACG
ACGATAGG	ACGATACG
ACGATAGT	ACGATACG
ACGATAGN	ACGATACG
ACAGGCCG	AGAGGCCG
ACGATATC	ACGATACG
ACAGGCCT	ACAGGACT
ACGATATG	ACGATACG
ACGATANC	ACGATACG
ACGATANG	ACGATACG
ACAGGCTA	ACAGGACT
ACAGGCTC	ACAGGACT
ACAGGCTG	ACAGGACT
ACGATCAC	ACGATACG
ACAGGCTT	ACAGGACT
ACAGGCTN	ACAGGACT
ACGATCCG	ACGATACG
ACAGGGAC	ACAGGACT
ACGATCGA	ACGATACG
ACGATCGC	ACGATACG
ACGATCGG	ACGATACG
ACGATCGT	ACGATACG
ACGATCGN	ACGATACG
ACAGGGCT	ACAGGACT
ACANGACT	ACAGGACT
ACGATGAC	ACGATACG
ACGATGCG	ACGATACG
ACAGGTAC	ACAGGACT
ACAGGTCT	ACAGGACT
ACGATTAC	ACGATACG
ACCNCGAA	ACCCGAAC
ACGATTCG	ACGATACG
ACAGGNAC	ACAGGACT
ACAGGNCT	ACAGGACT
ACANGGAC	ACAGGACT
ACGATNAC	ACGATACG
ACGATNCG	ACGATACG
ACAGTACT	ACAGGACT
ACGANACG	ACGATACG
ACCGTTGA	CCGTTGAA
ACGGCTTA	AGGCTTAA
ACCNGAAC	ACCCGAAC
ACAGTGAC	ACAGGACT
ACCCAAAC	ACCCGAAC
ACCCAACA	ACCCGAAC
ACGGGAAC	CGGGAACC
ACCCAACC	ACCCGAAC
ACCCAACG	ACCCGAAC
ACCCAACT	ACCCGAAC
ACCCAACN	ACCCGAAC
ACGGGACT	ACAGGACT
ACCCAATT	CCCAATTT
ACAGTTGC	AAGTTGCG
ACGANTAC	ACGATACG
ACCCACCG	CCCACCGT
ACGGGCGT	CCGGGCGT
ACGGGCTA	ATGGGCTA
ACCCAGAA	ACCCGAAC
ACAGNACT	ACAGGACT
ACGCAAAG	AGCAAAGG
ACGGGTAG	CGGGTAGG
ACACCAGA	CACCAGAG
ACAGNGAC	ACAGGACT
ACCCCAAC	ACCCGAAC
ACCTAAGC	ACTAAGCG
ACGGTACG	ACGATACG
ACACCCTG	AACCCTGG
ACCTAATA	GCCTAATA
ACGGTATA	TACGGTAT
ACGGTATC	TACGGTAT
ACGGTATG	TACGGTAT
ACGGTATT	TACGGTAT
ACACCGAA	ACCCGAAC
ACGGTATN	TACGGTAT
ACGCATAC	ACGATACG
ACCTAGCG	TCCTAGCG
ACCCCGAA	ACCCGAAC
ACGGTGGT	AGGTGGTT
ACACCTTC	CACCTTCG
ACATAAGC	ACTAAGCG
ACCCCTGG	AACCCTGG
ACGCCCAA	TACGCCCA
ACATACGA	ACGATACG
ACGCCCAC	TACGCCCA
ACATACGC	ACGATACG
ACGCCCAG	TACGCCCA
ACATACGG	ACGATACG
ACGCCCAT	TACGCCCA
ACATACGT	ACGATACG
ACGCCCAN	TACGCCCA
ACATACGN	ACGATACG
ACACGAAC	ACCCGAAC
ACGCCCTA	CCGCCCTA
ACACGACT	ACAGGACT
ACATAGCT	AATAGCTT
ACGCCGAA	ACCCGAAC
ACCCGAAA	ACCCGAAC
ACCAAAGA	CCAAAGAG
ACCCGAAC	ACCCGAAC
ACCCGAAG	ACCCGAAC
ACCAAAGG	AGCAAAGG
ACCCGAAT	ACCCGAAC
ACCCGAAN	ACCCGAAC
ACGCCGGG	GCGCCGGG
ACCCGACA	ACCCGAAC
ACCCGACC	ACCCGAAC
ACCCGACG	ACCCGAAC
ACCCGACT	ACCCGAAC
ACCCGACN	ACCCGAAC
ACCCGAGA	ACCCGAAC
ACCCGAGC	ACCCGAAC
ACCCGATA	ACCCGAAC
ACCCGATC	ACCCGAAC
ACCCGANA	ACCCGAAC
ACCCGANC	ACCCGAAC
ACCCGCAA	ACCCGAAC
ACCCGCAC	ACCCGAAC
ACCCGCCA	ATCCGCCA
ACACGGAC	ACAGGACT
ACCTCGAA	ACCCGAAC
ACCAAGCG	ACTAAGCG
ACCCGGAA	ACCCGAAC
ACCCGGAC	ACCCGAAC
ACCCGGCT	TCCCGGCT
ACGCGAAC	ACCCGAAC
ACGCGAAG	GCGCGAAG
ACCCGTAA	ACCCGAAC
ACCTCTCT	TCCTCTCT
ACCCGTAC	ACCCGAAC
ACCCGTCA	GACCCGTC
ACACGTTC	AAACGTTC
ACCCGTCC	GACCCGTC
ACCCGTCG	GACCCGTC
ACCCGTCT	GACCCGTC
ACCAATTT	CCCAATTT
ACCCGTCN	GACCCGTC
ACATCCAT	GCATCCAT
ACCCGNAA	ACCCGAAC
ACCCGNAC	ACCCGAAC
ACGAAACG	ACGATACG
ACCTGAAC	ACCCGAAC
ACACTAAC	AAACTAAC
ACCCTAAC	ACCCGAAC
ACGTAAGC	ACTAAGCG
ACACTAGT	CACTAGTT
ACGAACGA	ACGATACG
ACGAACGC	ACGATACG
ACGAACGG	ACGATACG
ACGAACGT	ACGATACG
ACGAACGN	ACGATACG
ACCACCGT	CCCACCGT
ACGTACGA	ACGATACG
ACGTACGC	ACGATACG
ACGTACGG	ACGATACG
ACGTACGT	ACGATACG
ACGAAGCG	ACTAAGCG
ACGTACGN	ACGATACG
ACCACGAA	ACCCGAAC
ACCCTGAA	ACCCGAAC
ACGAATAC	ACGATACG
ACCTGGTA	CCTGGTAC
ACCCTGGA	AACCCTGG
ACCCTGGC	AACCCTGG
ACCCTGGG	AACCCTGG
ACCCTGGT	AACCCTGG
ACCCTGGN	AACCCTGG
ACGCTACG	ACGATACG
ACATGACC	AATGACCG
ACATGACT	ACAGGACT
ACGTATAC	ACGATACG
ACNCGAAC	ACCCGAAC
ACATGGAC	ACAGGACT
ACCCNAAC	ACCCGAAC
ACGCTTAA	AGGCTTAA
ACTCTCAG	AGTCTCAG
ACATGTAG	AAATGTAG
ACGCTTCT	AGCTTCTT
ACTCTCCA	CTCTCCAT
ACCCNGAA	ACCCGAAC
ACNTAAGC	ACTAAGCG
ACTCTTTA	CTCTTTAA
ACGTCTCA	AGTCTCAG
ACATTATA	GACATTAT
ACATTATC	GACATTAT
ACATTATG	GACATTAT
ACATTATT	GACATTAT
ACATTATN	GACATTAT
ACGTCTGG	TCGTCTGG
ACTTCAAC	ATTCAACC
ACAGAACT	ACAGGACT
ACTTCCTG	ATTCCTGA
ACNAAGCG	ACTAAGCG
ACATTGTC	CCATTGTC
ACAGACTA	ACAGGACT
ACAGACTC	ACAGGACT
ACAGACTG	ACAGGACT
ACAGACTT	ACAGGACT
ACAGACTN	ACAGGACT
ACAGAGAC	ACAGGACT
ACTTCTTA	AGCTTCTT
ACTTCTTC	AGCTTCTT
ACTTCTTG	AGCTTCTT
ACTTCTTT	AGCTTCTT
ACTTCTTN	AGCTTCTT
ACAGATAA	CAGATAAT
ACAGATAC	ACGATACG
ACTAAACG	ACTAAGCG
ACTAAAGC	ACTAAGCG
ACTGAAGC	ACTAAGCG
ACTAACCG	ACTAAGCG
ACTAACGA	ACTAAGCG
ACTAACGC	ACTAAGCG
ACTAACGG	ACTAAGCG
ACTGACCG	AATGACCG
ACTAACGT	ACTAAGCG
ACTAACGN	ACTAAGCG
ACTAAGAC	ACTAAGCG
ACTAAGAG	ACTAAGCG
ACTAAGCA	ACTAAGCG
ACTAAGCC	ACTAAGCG
ACTAAGCG	ACTAAGCG
ACTAAGCT	ACTAAGCG
ACTAAGCN	ACTAAGCG
ACTAAGGA	ACTAAGCG
ACTAAGGC	ACTAAGCG
ACTAAGGG	ACTAAGCG
ACTGAGCG	ACTAAGCG
ACTAAGGT	ACTAAGCG
ACTAAGGN	ACTAAGCG
ACTAAGTC	ACTAAGCG
ACTAAGTG	ACTAAGCG
ACTAAGNC	ACTAAGCG
ACTAAGNG	ACTAAGCG
ACTGATAC	ACGATACG
ACTAATCG	ACTAAGCG
ACTAATGC	ACTAAGCG
ACTAANCG	ACTAAGCG
ACTAANGC	ACTAAGCG
ACTACAGC	ACTAAGCG
ACGTGGTT	AGGTGGTT
AGAAAAGG	AGCAAAGG
AGAAAATT	GAAAATTT
ACGTGTTA	GCGTGTTA
AGAAACAT	AAAACATG
ACNGATAC	ACGATACG
ACNAGGAC	ACAGGACT
ACTACGCG	ACTAAGCG
AGAAAGGA	AGCAAAGG
AGAAAGGC	AGCAAAGG
AGAAAGGG	AGCAAAGG
AGAAAGGT	AGCAAAGG
AGAAAGGN	AGCAAAGG
ACGTTACG	ACGATACG
AGAAATCC	AAAATCCC
ACTGGACT	ACAGGACT
ACGTTGAA	CCGTTGAA
ACNATACG	ACGATACG
ACGTTGCG	AAGTTGCG
AGAACATG	AAAACATG
ACTGGGCT	ATGGGCTA
ACTAGAGC	ACTAAGCG
ACTGGTAC	CCTGGTAC
AGAACGTT	AAACGTTC
AGAACTAA	AAACTAAC
ACNGGACT	ACAGGACT
ACTGTAGT	CTGTAGTC
ACTAGCGA	ACTAAGCG
ACTAGCGC	ACTAAGCG
ACTAGCGG	ACTAAGCG
ACTAGCGT	ACTAAGCG
ACTAGCGN	ACTAAGCG
ACTAGCTC	GCTAGCTC
ACTAGCTT	AATAGCTT
ACTAGGAC	ACAGGACT
ACTAGGCG	ACTAAGCG
AGAAGCCG	AGAGGCCG
AGAAGGCC	AGAGGCCG
AGAAGGGT	GAAGGGTA
ACTNAAGC	ACTAAGCG
ACTAGTTA	CACTAGTT
ACTAGTTC	CACTAGTT
ACTAGTTG	CACTAGTT
ACTAGTTT	CACTAGTT
ACTAGTTN	CACTAGTT
ACTNAGCG	ACTAAGCG
ACTATACG	ACGATACG
ACTATAGC	ACTAAGCG
ACTATATC	ATTATATC
AGAATCCC	AAAATCCC
ACTATGCA	CTATGCAA
ACTATGCG	ACTAAGCG
AGAATGTA	AAATGTAG
ACGNATAC	ACGATACG
AGAATTCG	GAATTCGT
ACTTAAGC	ACTAAGCG
ACTTAATG	CTTAATGA
ACTANAGC	ACTAAGCG
ACTTACCG	CTTACCGG
ACTTAGCG	ACTAAGCG
ACNCCGAA	ACCCGAAC
ACTTATAT	ATTATATC
ACTANGCG	ACTAAGCG
AGACAAAG	AGCAAAGG
ACTCAACC	ATTCAACC
AGANGCCG	AGAGGCCG
ACTCAAGC	ACTAAGCG
AGCGTCTT	AGCTTCTT
AGANGGCC	AGAGGCCG
AGCGTGGT	AGGTGGTT
AGCGTGTT	GCGTGTTA
ACTCAGCG	ACTAAGCG
AGCGTTCT	AGCTTCTT
AGACATTA	GACATTAT
AGGGGCCG	AGAGGCCG
AGGGGCTA	ATGGGCTA
ACGNTACG	ACGATACG
AGGGGGTT	AGGTGGTT
AGCCAAAG	AGCAAAGG
AGCCAAGG	AGCAAAGG
AGGCAAAG	AGCAAAGG
AGGGGTTA	AGGTGGTT
AGGGGTTC	AGGTGGTT
AGGGGTTG	AGGTGGTT
AGGGGTTT	AGGTGGTT
AGGGGTTN	AGGTGGTT
ACTCCGAA	ACCCGAAC
ACTCCGCC	ATCCGCCA
AGCNTCTT	AGCTTCTT
AGCTAAAG	AGCAAAGG
AGCTAAAT	TGCTAAAT
AGCTAAGC	ACTAAGCG
ACTCCTGA	ATTCCTGA
AGCTAAGG	AGCAAAGG
AGGGTAGG	CGGGTAGG
AGCNTTCT	AGCTTCTT
AGGCATAA	AGGCTTAA
AGCTACTT	AGCTTCTT
AGCCATGT	TGCCATGT
ACTCGAAC	ACCCGAAC
AGGCATTA	AGGCTTAA
AGCTAGCT	GCTAGCTC
ACTCGACT	ATCGACTT
AGGGTGGT	AGGTGGTT
AGGGTTAA	AGGCTTAA
AGCTATCT	AGCTTCTT
ACTCGGAA	ATCGGAAA
AGCAAAAG	AGCAAAGG
AGCAAACG	AGCAAAGG
AGCAAAGA	AGCAAAGG
AGCAAAGC	AGCAAAGG
AGCAAAGG	AGCAAAGG
AGCCCGAA	ACCCGAAC
AGCAAAGT	AGCAAAGG
AGCAAAGN	AGCAAAGG
AGCTCAGA	AGTCTCAG
AGCTCAGC	AGTCTCAG
AGCTCAGG	AGTCTCAG
AGCAAATG	AGCAAAGG
AGCTCAGT	AGTCTCAG
AGCTCAGN	AGTCTCAG
AGCAAANG	AGCAAAGG
AGCAACAG	AGCAAAGG
AGCAACGG	AGCAAAGG
AGGCCTAA	AGGCTTAA
AGCTCCTT	AGCTTCTT
AGCCCTGG	AACCCTGG
AGCAAGAG	AGCAAAGG
AGCAAGGA	AGCAAAGG
AGCAAGGC	AGCAAAGG
AGGCCTTA	AGGCTTAA
AGCAAGGG	AGCAAAGG
AGCAAGGT	AGCAAAGG
AGCAAGGN	AGCAAAGG
AGCAATAG	AGCAAAGG
AGCTCTCA	AGTCTCAG
AGGAAAGG	AGCAAAGG
AGCAATGG	AGCAAAGG
AGCTCTCT	AGCTTCTT
AGCCGAAC	ACCCGAAC
AGAGNCCG	AGAGGCCG
AGCTCTTA	AGCTTCTT
AGCTCTTC	AGCTTCTT
AGCTCTTG	AGCTTCTT
AGCTCTTT	AGCTTCTT
AGCTCTTN	AGCTTCTT
AGCAANAG	AGCAAAGG
AGCAANGG	AGCAAAGG
AGAGNGCC	AGAGGCCG
AGCCGCCA	ATCCGCCA
AGCACAAG	AGCAAAGG
AGACCCGT	GACCCGTC
AGCACAGG	AGCAAAGG
AGACCCTG	AACCCTGG
AGGCGGTT	AGGTGGTT
AGGCGTAA	AGGCTTAA
AGCTGCTT	AGCTTCTT
AGGCGTTA	AGGCTTAA
AGCTGGTT	AGGTGGTT
AGGTAGGT	AGGTGGTT
AGATAATA	CAGATAAT
AGATAATC	CAGATAAT
AGATAATG	CAGATAAT
AGATAATT	CAGATAAT
AGGTAGTT	AGGTGGTT
AGATAATN	CAGATAAT
AGCTGTCT	AGCTTCTT
AGATACGA	ACGATACG
AGCCTAAT	GCCTAATA
AGATACGC	ACGATACG
AGGCTAAA	AGGCTTAA
AGATACGG	ACGATACG
AGGCTAAC	AGGCTTAA
AGATACGT	ACGATACG
AGGCTAAG	AGGCTTAA
AGATACGN	ACGATACG
AGGCTAAT	AGGCTTAA
AGGCTAAN	AGGCTTAA
AGATAGAA	GATAGAAA
AGGCTATA	AGGCTTAA
AGATAGCT	AATAGCTT
AGCCTCAG	AGTCTCAG
AGGCTCAA	AGGCTTAA
AGGCTCAG	AGTCTCAG
AGCAGAAG	AGCAAAGG
AGCTTAAA	AGGCTTAA
AGCTTAAC	AGGCTTAA
AGCTTAAG	AGGCTTAA
AGCTTAAT	AGGCTTAA
AGCTTAAN	AGGCTTAA
AGCCTCTT	AGCTTCTT
AGGCTCTA	AGGCTTAA
AGCTTACT	AGCTTCTT
AGCAGAGG	AGCAAAGG
AGACGCCG	AGAGGCCG
AGGCTGAA	AGGCTTAA
AGCTTATT	AGCTTCTT
AGCTTCAT	AGCTTCTT
AGGCTGGT	AGGTGGTT
AGGCTGTA	AGGCTTAA
AGCTTCCT	AGCTTCTT
AGGACTTA	AGGCTTAA
AGCCTTAA	AGGCTTAA
AGCTTCGT	AGCTTCTT
AGCTTCTA	AGCTTCTT
AGCTTCTC	AGCTTCTT
AGGCTTAA	AGGCTTAA
AGCTTCTG	AGCTTCTT
AGGCTTAC	AGGCTTAA
AGCTTCTT	AGCTTCTT
AGGCTTAG	AGGCTTAA
AGCTTCTN	AGCTTCTT
AGGCTTAT	AGGCTTAA
AGGCTTAN	AGGCTTAA
AGCCTTCT	AGCTTCTT
AGACGGCC	AGAGGCCG
AGGCTTCA	AGGCTTAA
AGCTTCNT	AGCTTCTT
AGCAGGAC	ACAGGACT
AGGCTTCT	AGCTTCTT
AGGCTTGA	AGGCTTAA
AGCAGGCC	AGAGGCCG
AGGCTTTA	AGGCTTAA
AGCTTGCT	AGCTTCTT
AGGCTTNA	AGGCTTAA
AGGCTNAA	AGGCTTAA
AGGTCGGT	AGGTGGTT
AGCTTGTT	AGCTTCTT
AGGTCGTT	AGGTGGTT
AGGAGACT	TGGAGACT
AGGCTNTA	AGGCTTAA
AGCTTTCT	AGCTTCTT
AGGTCTCA	AGTCTCAG
AGACGTTC	AAACGTTC
AGCTTTTA	AGCTTCTT
AGCTTTTC	AGCTTCTT
AGCTTTTG	AGCTTCTT
AGCTTTTT	AGCTTCTT
AGCTTTTN	AGCTTCTT
AGGTCTTA	AGGCTTAA
AGCTTNCT	AGCTTCTT
AGCTTNTT	AGCTTCTT
AGCATAAG	AGCAAAGG
AGACTAAC	AAACTAAC
AGGAGGCC	AGAGGCCG
AGCATAGG	AGCAAAGG
AGATCTCA	AGTCTCAG
AGGAGGTT	AGGTGGTT
AGGTGAGT	AGGTGGTT
AGGTGATT	AGGTGGTT
AGCATCCA	GCATCCAT
AGACTCAG	AGTCTCAG
AGGCNTAA	AGGCTTAA
AGCTNCTT	AGCTTCTT
AGCATCTT	AGCTTCTT
AGGTGCGT	AGGTGGTT
AGGTGCTT	AGGTGGTT
AGGCNTTA	AGGCTTAA
AGGTGGAT	AGGTGGTT
AGGTGGCT	AGGTGGTT
AGATGACC	AATGACCG
AGGTGGGT	AGGTGGTT
AGGTGGTA	AGGTGGTT
AGGTGGTC	AGGTGGTT
AGGTGGTG	AGGTGGTT
AGGTGGTT	AGGTGGTT
AGGTGGTN	AGGTGGTT
AGGTGGNT	AGGTGGTT
AGGATACG	ACGATACG
AGCTNTCT	AGCTTCTT
AGCATTCT	AGCTTCTT
AGACTTAA	AGGCTTAA
AGCGAAAG	AGCAAAGG
AGGTGTGT	AGGTGGTT
AGATGCCG	AGAGGCCG
AGGTGTTA	AGGTGGTT
AGGTGTTC	AGGTGGTT
AGGGAACC	CGGGAACC
AGGTGTTG	AGGTGGTT
AGGTGTTT	AGGTGGTT
AGGTGTTN	AGGTGGTT
AGACTTCT	AGCTTCTT
AGCGAAGG	AGCAAAGG
AGGTGNGT	AGGTGGTT
AGATGGCC	AGAGGCCG
AGGTGNTT	AGGTGGTT
AGCNAAAG	AGCAAAGG
AGCANAAG	AGCAAAGG
AGGTTAAA	AGGCTTAA
AGGTTAAC	AGGCTTAA
AGATGGTT	AGGTGGTT
AGCGACTT	ATCGACTT
AGGTTAAG	AGGCTTAA
AGGTTAAT	AGGCTTAA
AGGTTAAN	AGGCTTAA
AGCNAAGG	AGCAAAGG
AGGATGGT	AGGTGGTT
AGCANAGG	AGCAAAGG
AGATGTAG	AAATGTAG
AGGATTAA	AGGCTTAA
AGCGATAC	ACGATACG
AGGTTCTT	AGCTTCTT
AGGTTGCG	AAGTTGCG
AGGTTGGT	AGGTGGTT
AGGTTGTT	AGGTGGTT
AGGTTTAA	AGGCTTAA
AGATTCTT	AGCTTCTT
AGCGCCGG	GCGCCGGG
AGGGCCGA	AGAGGCCG
AGGGCCGC	AGAGGCCG
AGGGCCGG	AGAGGCCG
AGGGCCGT	AGAGGCCG
AGGGCCGN	AGAGGCCG
AGCGCGAA	GCGCGAAG
AGGGCTAA	ATGGGCTA
AGGGCTAC	ATGGGCTA
AGGGCTAG	ATGGGCTA
AGNAGGCC	AGAGGCCG
AGGGCTAT	ATGGGCTA
AGCGCTTA	AGGCTTAA
AGGGCTAN	ATGGGCTA
AGGTNGGT	AGGTGGTT
AGGGCTTA	AGGCTTAA
AGGTNGTT	AGGTGGTT
AGAGACCG	AGAGGCCG
AGTGCTCA	AGTCTCAG
AGATTTCC	GATTTCCC
AGCGGAAA	ATCGGAAA
AGTGCTTA	AGGCTTAA
AGAGAGCC	AGAGGCCG
AGCGGCCG	AGAGGCCG
ATAACATG	AAAACATG
AGNGCTTA	AGGCTTAA
AGNTTCTT	AGCTTCTT
ATAACCAG	TAACCAGC
AGTGGCAC	GTGGCACC
AGTGGCCG	AGAGGCCG
AGTGGGCT	ATGGGCTA
AGTGGGGT	TGTGGGGT
ATAACGTT	AAACGTTC
ATAACTAA	AAACTAAC
AGNGGCCG	AGAGGCCG
AGTGGTTA	AGGTGGTT
AGTGGTTC	AGGTGGTT
AGTGGTTG	AGGTGGTT
AGTGGTTT	AGGTGGTT
AGTGGTTN	AGGTGGTT
AGAGCCCG	AGAGGCCG
AGAGCCGA	AGAGGCCG
AGAGCCGC	AGAGGCCG
AGAGCCGG	AGAGGCCG
AGAGCCGT	AGAGGCCG
AGAGCCGN	AGAGGCCG
AGAGCGCC	AGAGGCCG
ATAAGATC	TAAGATCG
AGTGTCAG	AGTCTCAG
ATAAGCGA	ACTAAGCG
ATAAGCGC	ACTAAGCG
ATAAGCGG	ACTAAGCG
ATAAGCGT	ACTAAGCG
ATAAGCGN	ACTAAGCG
AGAGCTTA	AGGCTTAA
ATAAGGGA	TATAAGGG
ATAAGGGC	TATAAGGG
ATAAGGGG	TATAAGGG
ATAAGGGT	TATAAGGG
ATAAGGGN	TATAAGGG
AGTGTGGT	AGGTGGTT
AGAGGACC	AGAGGCCG
AGAGGACG	AGAGGCCG
AGAGGACT	ACAGGACT
AGNGTGGT	AGGTGGTT
AGAGGCAC	AGAGGCCG
AGAGGCAG	AGAGGCCG
AGAGGCAT	TGAGGCAT
AGAGGCCA	AGAGGCCG
AGAGGCCC	AGAGGCCG
AGAGGCCG	AGAGGCCG
AGAGGCCT	AGAGGCCG
AGAGGCCN	AGAGGCCG
AGAGGCGA	AGAGGCCG
AGNCAAAG	AGCAAAGG
AGAGGCGC	AGAGGCCG
AGAGGCGG	AGAGGCCG
AGAGGCGT	AGAGGCCG
AGAGGCGN	AGAGGCCG
AGAGGCTC	AGAGGCCG
AGAGGCTG	AGAGGCCG
AGAGGCNC	AGAGGCCG
AGAGGCNG	AGAGGCCG
ATAATATC	ATTATATC
AGAGGGCC	AGAGGCCG
AGAGGGCG	AGAGGCCG
ATAATCCC	AAAATCCC
AGAGGTCC	AGAGGCCG
AGAGGTCG	AGAGGCCG
ATAATGTA	AAATGTAG
ATAATTAC	TAATTACA
AGAGGNCC	AGAGGCCG
AGAGGNCG	AGAGGCCG
AGAGTCCG	AGAGGCCG
AGAGTCGG	GAGTCGGT
AGAGTGCC	AGAGGCCG
AGTNCTCA	AGTCTCAG
AGAGTGGT	AGGTGGTT
AGAGTTGC	AAGTTGCG
AGAGTTTA	CGAGTTTA
AGTATATC	ATTATATC
AGTTATAT	ATTATATC
AGTATCAG	AGTCTCAG
ATACAACC	ATTCAACC
AGTTCAAC	ATTCAACC
AGTTCAGA	AGTCTCAG
AGTTCAGC	AGTCTCAG
AGTTCAGG	AGTCTCAG
AGTTCAGT	AGTCTCAG
AGTTCAGN	AGTCTCAG
AGTTCCTG	ATTCCTGA
AGTTCTCA	AGTCTCAG
AGTTCTTA	AGCTTCTT
AGTTCTTC	AGCTTCTT
AGTTCTTG	AGCTTCTT
AGTTCTTT	AGCTTCTT
AGTTCTTN	AGCTTCTT
AGNTCTCA	AGTCTCAG
AGTNTCAG	AGTCTCAG
AGNCTCAG	AGTCTCAG
ATACCCTG	AACCCTGG
AGTTGCGA	AAGTTGCG
AGTTGCGC	AAGTTGCG
ATACCGAA	GTACCGAA
AGTTGCGG	AAGTTGCG
AGTTGCGT	AAGTTGCG
AGTTGCGN	AAGTTGCG
ATACCGCC	ATCCGCCA
AGNCTTAA	AGGCTTAA
AGNCTTCT	AGCTTCTT
AGTTGGTT	AGGTGGTT
ATACCTGA	ATTCCTGA
AGGNCTTA	AGGCTTAA
AGNTGGTT	AGGTGGTT
ATACGACT	ATCGACTT
AGTTTAAA	GTTTAAAG
AGTCAAAG	AGCAAAGG
AGTCAAAT	GTCAAATG
AGTCAACC	ATTCAACC
ATACGCCA	ATCCGCCA
ATACGCCC	TACGCCCA
AGTTTCAG	AGTCTCAG
AGTCACAG	AGTCTCAG
ATACGGAA	ATCGGAAA
AGTTTCTT	AGCTTCTT
ATACGGTA	TACGGTAT
AGTTTGAC	GTTTGACT
AGGNGGTT	AGGTGGTT
AGTCAGGC	GTCAGGCT
ATACGTTC	AAACGTTC
AGTTTTGC	TGTTTTGC
AGTCATCA	AGTCTCAG
AGNAAAGG	AGCAAAGG
ATCTCAAC	ATTCAACC
ATACTAAC	AAACTAAC
ATCTCAGA	AGTCTCAG
ATCTCAGC	AGTCTCAG
ATAAACAT	AAAACATG
ATCTCAGG	AGTCTCAG
ATCTCAGT	AGTCTCAG
ATCTCAGN	AGTCTCAG
ATCTCCAT	CTCTCCAT
ATCAAAGG	AGCAAAGG
ATCAAATG	GTCAAATG
ATCTCCTG	ATTCCTGA
ATCAACAA	TCAACAAC
AGTCCAGA	AGTCTCAG
AGTCCAGC	AGTCTCAG
AGTCCAGG	AGTCTCAG
ATCAACCA	ATTCAACC
ATCAACCC	ATTCAACC
ATCAACCG	ATTCAACC
ATCAACCT	ATTCAACC
ATCAACCN	ATTCAACC
AGTCCAGT	AGTCTCAG
AGTCCAGN	AGTCTCAG
ATCTCGCC	ATCCGCCA
ATCAACTT	ATCGACTT
ATAAATCC	AAAATCCC
AGGNTGGT	AGGTGGTT
AGTCCCAG	AGTCTCAG
AGGNTTAA	AGGCTTAA
ATGCGACT	ATCGACTT
ATCTGAAA	ATCGGAAA
ATCTGACT	ATCGACTT
ATGCGCCA	ATCCGCCA
AGTCCGCC	ATCCGCCA
ATGCGCTA	ATGGGCTA
ATCTGCCA	ATCCGCCA
ATGCGGAA	ATCGGAAA
ATGACAGC	TTGACAGC
ATGCGGCT	ATGGGCTA
AGTCCTCA	AGTCTCAG
AGTCCTGA	ATTCCTGA
ATCTGGAA	ATCGGAAA
ATGACCGA	AATGACCG
ATGACCGC	AATGACCG
ATGACCGG	AATGACCG
ATGACCGT	AATGACCG
ATGACCGN	AATGACCG
ATGTAGTC	CTGTAGTC
ATGCGTTC	TTGCGTTC
ATCACGCC	ATCCGCCA
ATGTATAT	ATTATATC
AGTCGACT	ATCGACTT
ATGCTAAA	TGCTAAAT
ATCACTTA	ATCGACTT
ATCACTTC	ATCGACTT
ATCACTTG	ATCGACTT
ATCACTTT	ATCGACTT
ATCACTTN	ATCGACTT
ATCCTAGC	TCCTAGCG
ATGACTTA	ATCGACTT
ATGACTTC	ATCGACTT
ATGACTTG	ATCGACTT
ATGACTTT	ATCGACTT
ATGACTTN	ATCGACTT
AGTCGCAG	AGTCTCAG
ATGTCAAC	ATTCAACC
ATCCTCCA	ATCCGCCA
ATCCTCTC	TCCTCTCT
ATCAGAAA	ATCGGAAA
AGTCGGAA	ATCGGAAA
ATCCTGAA	ATTCCTGA
ATCAGACT	ATCGACTT
ATCCTGAC	ATTCCTGA
AGTAAAGG	AGCAAAGG
ATCCTGAG	ATTCCTGA
ATCCTGAT	ATTCCTGA
ATCCTGAN	ATTCCTGA
ATCCTGCC	ATCCGCCA
ATGTCCGA	TTGTCCGA
ATCTTCTT	AGCTTCTT
ATGTCCTG	ATTCCTGA
AGTCGGTA	GAGTCGGT
AGTCGGTC	GAGTCGGT
AGTCGGTG	GAGTCGGT
AGTCGGTT	GAGTCGGT
AGTCGGTN	GAGTCGGT
ATCAGCCA	ATCCGCCA
ATGCTTAA	AGGCTTAA
AGTCGTCA	AGTCTCAG
ATGCTTCT	AGCTTCTT
ATGAGCTA	ATGGGCTA
ATCAGGAA	ATCGGAAA
ATCAGGAC	ACAGGACT
ATCTTTAA	CTCTTTAA
AGTAAGCG	ACTAAGCG
ATCAGGCT	GTCAGGCT
ATGAGGCA	TGAGGCAT
ATGTCTCA	AGTCTCAG
ATGAGGCC	AGAGGCCG
ATGAGGCT	ATGGGCTA
AGTCTAAG	AGTCTCAG
AGTCTACA	AGTCTCAG
AGTCTAGA	AGTCTCAG
AGTCTAGC	AGTCTCAG
AGTCTAGG	AGTCTCAG
AGTCTAGT	AGTCTCAG
AGTCTAGN	AGTCTCAG
ATCCNCCA	ATCCGCCA
ATGATACG	ACGATACG
ATCATATC	ATTATATC
ATGATATC	ATTATATC
ATCCNGCC	ATCCGCCA
ATGTGCTA	ATGGGCTA
AGTCTCAA	AGTCTCAG
AGTCTCAC	AGTCTCAG
AGTCTCAG	AGTCTCAG
AGTCTCAT	AGTCTCAG
AGTCTCAN	AGTCTCAG
AGTCTCCA	AGTCTCAG
AGTACCGA	GTACCGAA
ATGTGGCT	ATGGGCTA
ATGTGGGG	TGTGGGGT
ATGTGGTT	AGGTGGTT
AGTCTCCG	AGTCTCAG
AGTCTCGA	AGTCTCAG
AGTCTCGC	AGTCTCAG
AGTCTCGG	AGTCTCAG
AGTCTCGT	AGTCTCAG
AGTCTCGN	AGTCTCAG
AGTCTCTA	AGTCTCAG
AGTCTCTG	AGTCTCAG
AGTCTCNA	AGTCTCAG
AGTCTCNG	AGTCTCAG
AGTACTCA	AGTCTCAG
ATGGAAAA	ATCGGAAA
AGTCTGAG	AGTCTCAG
ATGGAAAC	ATCGGAAA
ATGGAAAG	ATCGGAAA
ATGGAAAT	ATCGGAAA
AGTCTGCA	AGTCTCAG
ATGGAAAN	ATCGGAAA
ATCGAAAA	ATCGGAAA
ATCGAAAC	ATCGGAAA
ATCGAAAG	ATCGGAAA
ATCGAAAT	ATCGGAAA
ATCGAAAN	ATCGGAAA
AGTCTTAA	AGGCTTAA
AGTCTTAG	AGTCTCAG
ATGGACTA	ATGGGCTA
ATGGACTT	ATCGACTT
ATCGAACT	ATCGACTT
ATGGAGAC	TGGAGACT
ATCGAATT	ATCGACTT
ATGGAGCT	ATGGGCTA
ATCNACTT	ATCGACTT
ATCGACAT	ATCGACTT
ATCGACCT	ATCGACTT
ATGTTGCG	AAGTTGCG
ATCGACGT	ATCGACTT
ATCGACTA	ATCGACTT
ATCGACTC	ATCGACTT
ATCGACTG	ATCGACTT
ATCGACTT	ATCGACTT
ATCGACTN	ATCGACTT
AGTAGCTT	AATAGCTT
ATCGACNT	ATCGACTT
ATCGAGAA	ATCGGAAA
AGTCTTCA	AGTCTCAG
AGTCTTCT	AGCTTCTT
AGTAGGCC	AGAGGCCG
ATCGAGCT	ATCGACTT
ATGTTTTG	TGTTTTGC
ATCGAGTC	TCGAGTCC
ATCGAGTT	ATCGACTT
ATCGATAC	ACGATACG
AGTCTNAG	AGTCTCAG
AGTCTNCA	AGTCTCAG
ATGGCACC	GTGGCACC
ATCGATCT	ATCGACTT
ATCGATTA	ATCGACTT
ATCGATTC	ATCGACTT
ATCGATTG	ATCGACTT
ATCGATTT	ATCGACTT
ATCGATTN	ATCGACTT
ATGCAAAG	AGCAAAGG
ATGCAACC	ATTCAACC
ATCCAAAA	TTCCAAAA
ATCGANCT	ATCGACTT
ATCCAACC	ATTCAACC
ATGGCCTA	ATGGGCTA
ATCGANTT	ATCGACTT
ATCCACCA	ATCCGCCA
ATCGCAAA	ATCGGAAA
ATGGCGCT	ATGGGCTA
ATCGCACT	ATCGACTT
ATCCACTT	ATCGACTT
AGTCNCAG	AGTCTCAG
ATCNCGCC	ATCCGCCA
ATGGCTAA	ATGGGCTA
ATGGCTAC	ATGGGCTA
ATGGCTAG	ATGGGCTA
ATGGCTAT	ATGGGCTA
ATGGCTAN	ATGGGCTA
ATCGCCAA	ATCCGCCA
ATCCAGCC	ATCCGCCA
ATCGCCAC	ATCCGCCA
ATCGCCAG	ATCCGCCA
ATCGCCAT	ATCCGCCA
ATCGCCAN	ATCCGCCA
ATGGCTTA	AGGCTTAA
ATCGCCTT	ATCGACTT
ATCGCGAA	ATCGGAAA
ATCGCGCC	ATCCGCCA
ATGGGAAA	ATCGGAAA
ATGGGACT	ATGGGCTA
AGTCNTCA	AGTCTCAG
ATGGGATA	ATGGGCTA
ATCNGAAA	ATCGGAAA
ATCNGACT	ATCGACTT
ATCGCTTA	ATCGACTT
ATGGGCAA	ATGGGCTA
ATCGCTTC	ATCGACTT
ATGGGCAC	ATGGGCTA
ATCGCTTG	ATCGACTT
ATGGGCAG	ATGGGCTA
ATCGCTTT	ATCGACTT
ATGGGCAT	ATGGGCTA
ATCGCTTN	ATCGACTT
ATGGGCAN	ATGGGCTA
ATGGGCCA	ATGGGCTA
ATGGGCCT	ATGGGCTA
ATGGGCGA	ATGGGCTA
ATGCCATG	TGCCATGT
ATGGGCGT	ATGGGCTA
ATGGGCTA	ATGGGCTA
ATGGGCTC	ATGGGCTA
ATGGGCTG	ATGGGCTA
ATGGGCTT	ATGGGCTA
ATGGGCTN	ATGGGCTA
ATGGGCNA	ATGGGCTA
ATCNGCCA	ATCCGCCA
ATAGAAAA	GATAGAAA
ATGGGCNT	ATGGGCTA
ATAGAAAC	GATAGAAA
ATAGAAAG	GATAGAAA
ATAGAAAT	GATAGAAA
ATAGAAAN	GATAGAAA
ATCCCCAA	ATCCGCCA
ATCCCCAC	ATCCGCCA
ATCCCCAG	ATCCGCCA
ATCCCCAT	ATCCGCCA
ATCCCCAN	ATCCGCCA
ATGGGGCT	ATGGGCTA
ATCCCCCA	ATCCGCCA
ATCGGAAA	ATCGGAAA
ATCGGAAC	ATCGGAAA
ATCGGAAG	ATCGGAAA
ATCGGAAT	ATCGGAAA
ATCGGAAN	ATCGGAAA
ATCGGACA	ATCGGAAA
ATGGGGTA	ATGGGCTA
ATCNGGAA	ATCGGAAA
ATCGGACT	ATCGACTT
ATCGGAGA	ATCGGAAA
ATGCCGCC	ATCCGCCA
ATCGGATA	ATCGGAAA
ATGGGTAA	ATGGGCTA
ATGGGTAC	ATGGGCTA
ATGGGTAG	ATGGGCTA
ATGGGTAT	ATGGGCTA
ATCCCGAA	ACCCGAAC
ATGGGTAN	ATGGGCTA
ATCGGANA	ATCGGAAA
ATGGGTCT	ATGGGCTA
ATCCCGCC	ATCCGCCA
ATCGGCAA	ATCGGAAA
ATCCCGGC	TCCCGGCT
ATGGGTTA	ATGGGCTA
ATCGGCCA	ATCCGCCA
ATAGACTT	ATCGACTT
AGTGACCG	AATGACCG
ATCGGCTA	ATGGGCTA
ATCGGCTT	ATCGACTT
ATGCCTGA	ATTCCTGA
ATGGGNCT	ATGGGCTA
ATCGGGAA	ATCGGAAA
ATCCCTGA	ATTCCTGA
ATGGGNTA	ATGGGCTA
ATCCCTGG	AACCCTGG
ATCGGGCT	ATGGGCTA
ATCGGTAA	ATCGGAAA
ATCCGAAA	ATCGGAAA
ATCCGAAC	ACCCGAAC
ATCCGACA	ATCCGCCA
ATCCGACC	ATCCGCCA
ATCGGNAA	ATCGGAAA
ATCCGACT	ATCGACTT
ATGGTCTA	ATGGGCTA
ATCCGCAA	ATCCGCCA
ATCCGCAC	ATCCGCCA
ATCCGCAG	ATCCGCCA
ATGGTGCT	ATGGGCTA
ATCCGCAT	ATCCGCCA
ATCCGCAN	ATCCGCCA
ATCCGCCA	ATCCGCCA
ATCCGCCC	ATCCGCCA
ATCGTAAA	ATCGGAAA
ATCCGCCG	ATCCGCCA
ATGGTGGT	AGGTGGTT
ATCCGCCT	ATCCGCCA
ATCCGCCN	ATCCGCCA
ATCCGCGA	ATCCGCCA
ATCCGCGC	ATCCGCCA
ATCGTACT	ATCGACTT
ATCCGCTA	ATCCGCCA
ATCCGCTC	ATCCGCCA
ATCCGCNA	ATCCGCCA
ATCCGCNC	ATCCGCCA
ATCCGGAA	ATCGGAAA
ATCCGGCA	ATCCGCCA
ATCCGGCC	ATCCGCCA
ATATGACC	AATGACCG
ATCGTCTG	TCGTCTGG
ATCGTCTT	ATCGACTT
ATCCGTCA	ATCCGCCA
ATCGTGAA	ATCGGAAA
ATCCGTCC	ATCCGCCA
ATATGCAA	CTATGCAA
ATCCGNCA	ATCCGCCA
ATCCGNCC	ATCCGCCA
ATAGCTTA	AATAGCTT
ATAGCTTC	AATAGCTT
ATAGCTTG	AATAGCTT
ATAGCTTT	AATAGCTT
ATAGCTTN	AATAGCTT
ATNCAACC	ATTCAACC
ATGGNCTA	ATGGGCTA
ATATGTAG	AAATGTAG
ATAGGAAA	ATCGGAAA
ATGNGCTA	ATGGGCTA
ATGGNGCT	ATGGGCTA
ATAGGACG	TTAGGACG
ATAGGACT	ACAGGACT
ATCGNAAA	ATCGGAAA
ATGNGGCT	ATGGGCTA
ATCGNACT	ATCGACTT
ATAGGCCG	AGAGGCCG
ATAGGCTA	ATGGGCTA
ATAGGGCT	ATGGGCTA
ATCGNCTT	ATCGACTT
ATCGNGAA	ATCGGAAA
ATTTAAAG	GTTTAAAG
ATTTAACC	ATTCAACC
ATATTGGC	TATTGGCG
ATNCCGCC	ATCCGCCA
ATCTAAGC	ACTAAGCG
ATTTATAT	ATTATATC
ATTTATCA	ATTATATC
ATNCCTGA	ATTCCTGA
ATTTATCC	ATTATATC
ATTTATCG	ATTATATC
ATTTATCT	ATTATATC
ATTTATCN	ATTATATC
ATNTATAT	ATTATATC
ATCTACTT	ATCGACTT
ATAGTTGC	AAGTTGCG
ATTTCAAC	ATTCAACC
ATNCGACT	ATCGACTT
ATCTATAT	ATTATATC
ATNCGCCA	ATCCGCCA
ATNTCAAC	ATTCAACC
ATTTCCCA	GATTTCCC
ATTTCCCC	GATTTCCC
ATTTCCCG	GATTTCCC
ATTTCCCT	GATTTCCC
ATTTCCCN	GATTTCCC
ATTTCCTG	ATTCCTGA
ATNCGGAA	ATCGGAAA
ATNTCCTG	ATTCCTGA
ATTTCTGA	ATTCCTGA
ATTTGACT	GTTTGACT
ANACCCTG	AACCCTGG
ATATAAGG	TATAAGGG
ATTNTATC	ATTATATC
ATTTGTGG	TTTGTGGA
ATATAGCT	AATAGCTT
ATATATAT	ATTATATC
ATATATCA	ATTATATC
ATATATCC	ATTATATC
ATATATCG	ATTATATC
ATATATCT	ATTATATC
ATATATCN	ATTATATC
ATTTTATC	ATTATATC
ATATCAAC	ATTCAACC
ATATCACT	TTATCACT
ANACGTTC	AAACGTTC
ATATCCTG	ATTCCTGA
ANACTAAC	AAACTAAC
ANAAACAT	AAAACATG
ATNGACTT	ATCGACTT
ANAAATCC	AAAATCCC
ANAACATG	AAAACATG
ATTNAACC	ATTCAACC
ANAACGTT	AAACGTTC
ANAACTAA	AAACTAAC
ATTNATAT	ATTATATC
ATTNCAAC	ATTCAACC
ATNGGAAA	ATCGGAAA
ATTNCCTG	ATTCCTGA
ATNGGCTA	ATGGGCTA
ATTAAACC	ATTCAACC
ATNGGGCT	ATGGGCTA
ATTAAATC	ATTATATC
ATTAACCA	ATTCAACC
ATTAACCC	ATTCAACC
ATTAACCG	ATTCAACC
ATTAACCT	ATTCAACC
ATTAACCN	ATTCAACC
ATTNCTGA	ATTCCTGA
ATTAAGCG	ACTAAGCG
ATTAATAT	ATTATATC
ANAATCCC	AAAATCCC
ATTAATCA	ATTATATC
ATTAATCC	ATTATATC
ATTAATCG	ATTATATC
ATTAATCT	ATTATATC
ATTAATCN	ATTATATC
ATTAATGA	CTTAATGA
ANAATGTA	AAATGTAG
ANGAGGCC	AGAGGCCG
ATTACAAC	ATTCAACC
ATTACATC	ATTATATC
ATTCCAAA	TTCCAAAA
ATTCCAAC	ATTCAACC
ATTCCACC	ATTCAACC
ATTCCAGA	ATTCCTGA
ATTCCATG	ATTCCTGA
ATTACCGG	CTTACCGG
ATTACCTG	ATTCCTGA
ATTCCCGA	ATTCCTGA
ATTCCCTG	ATTCCTGA
ATTCCGAA	ATTCCTGA
ATTCCGAC	ATTCCTGA
ATTCCGAG	ATTCCTGA
ATTCCGAT	ATTCCTGA
ATTCCGAN	ATTCCTGA
ATTCCGCC	ATCCGCCA
ATNATATC	ATTATATC
ATTACTAT	ATTATATC
ATTCCGGA	ATTCCTGA
ATTACTGA	ATTCCTGA
ATTCCGTG	ATTCCTGA
ATTCCTAA	ATTCCTGA
ATTCCTAC	ATTCCTGA
ATTCCTAG	ATTCCTGA
ATTCCTAT	ATTCCTGA
ATTCCTAN	ATTCCTGA
ATTCCTCA	ATTCCTGA
ATTCCTCG	ATTCCTGA
ATTCCTGA	ATTCCTGA
ATTCCTGC	ATTCCTGA
ATTCCTGG	ATTCCTGA
ATTCCTGT	ATTCCTGA
ATTCCTGN	ATTCCTGA
ATTCCTTA	ATTCCTGA
ANGTTGCG	AAGTTGCG
ATTCCTTG	ATTCCTGA
ATTCCTNA	ATTCCTGA
ATTCCTNG	ATTCCTGA
ANGATACG	ACGATACG
ATTCCNGA	ATTCCTGA
ATTCCNTG	ATTCCTGA
ATTAGATC	ATTATATC
ATTCGAAC	ATTCAACC
ATTCGACC	ATTCAACC
ATTCGACT	ATCGACTT
ATTAGCTT	AATAGCTT
ATTAGGAC	TTAGGACG
ATTCGCCA	ATCCGCCA
ATTCGCTG	ATTCCTGA
ATTCGGAA	ATCGGAAA
ATTAGTAT	ATTATATC
ATTCGTGA	ATTCCTGA
ANGGCTTA	AGGCTTAA
ATTATAAC	ATTATATC
ATTATAAT	ATTATATC
ATTATACA	ATTATATC
ATTATACC	ATTATATC
ATTATACG	ATTATATC
ATTATACT	ATTATATC
ATTATACN	ATTATATC
ATTATAGC	ATTATATC
ATTATAGT	ATTATATC
ATTATATA	ATTATATC
ATTATATC	ATTATATC
ATTATATG	ATTATATC
ATTATATT	ATTATATC
ATTATATN	ATTATATC
ATTATANC	ATTATATC
ATTATANT	ATTATATC
ATTATCAC	TTATCACT
ATTATCAT	ATTATATC
ATTCTAAC	ATTCAACC
ATTCTACC	ATTCAACC
ATTATCTC	ATTATATC
ATTCTATC	ATTATATC
ATTATGAT	ATTATATC
ATTCTCAG	AGTCTCAG
ATTATGTC	ATTATATC
ANGGGCTA	ATGGGCTA
ATTCTCTG	ATTCCTGA
ATTATTAT	ATTATATC
ATTATTCA	ATTATATC
ATTATTCC	ATTATATC
ATTATTCG	ATTATATC
ATTCTGAA	ATTCCTGA
ATTATTCT	ATTATATC
ATTATTCN	ATTATATC
ATTCTGAC	ATTCCTGA
ATTCTGAG	ATTCCTGA
ATTCTGAT	ATTCCTGA
ATTCTGAN	ATTCCTGA
ATTATTTC	ATTATATC
ANCCCGAA	ACCCGAAC
ATTATNAT	ATTATATC
ATTATNTC	ATTATATC
ATTCTTGA	ATTCCTGA
ANCCCTGG	AACCCTGG
ATTANATC	ATTATATC
ANGCAAAG	AGCAAAGG
ATTCNAAC	ATTCAACC
ANCCGAAC	ACCCGAAC
ATTCNACC	ATTCAACC
ANCCGCCA	ATCCGCCA
ANCGGAAA	ATCGGAAA
ATTANTAT	ATTATATC
ATTCNCTG	ATTCCTGA
ANGGTGGT	AGGTGGTT
ATTCAAAC	ATTCAACC
ATTCAACA	ATTCAACC
ATTCAACC	ATTCAACC
ATTCAACG	ATTCAACC
ATTCAACT	ATTCAACC
ATTCAACN	ATTCAACC
ATTCNTGA	ATTCCTGA
ATTCAAGC	ATTCAACC
ATTCAATC	ATTCAACC
ATTCAANC	ATTCAACC
ATTCACAC	ATTCAACC
ATTCACCA	ATTCAACC
ATTCACCC	ATTCAACC
ATTCACCG	ATTCAACC
ATTCACCT	ATTCAACC
ATTCACCN	ATTCAACC
ATTCACTG	ATTCCTGA
ATTCAGAC	ATTCAACC
ATTCAGCC	ATTCAACC
ATTGAACC	ATTCAACC
ATTCATAC	ATTCAACC
ATTCATAT	ATTATATC
ATTCATCC	ATTCAACC
ATTGACAG	TTGACAGC
ATTCATGA	ATTCCTGA
ATTGACCG	AATGACCG
ATTGACTT	ATCGACTT
ATTCANAC	ATTCAACC
ATTCANCC	ATTCAACC
ANAGGACT	ACAGGACT
ATTGATAT	ATTATATC
ANAGGCCG	AGAGGCCG
ATTGCAAC	ATTCAACC
ATTGCCTG	ATTCCTGA
ATTGCGTT	TTGCGTTC
ATTGCTGA	ATTCCTGA
ATTGGAAA	ATCGGAAA
ANCGACTT	ATCGACTT
ANAGTTGC	AAGTTGCG
ANCTAAGC	ACTAAGCG
ANGTCTCA	AGTCTCAG
ANCGATAC	ACGATACG
ATTGGCGA	TATTGGCG
ATTGGCGC	TATTGGCG
ATTGGCGG	TATTGGCG
ATTGGCGT	TATTGGCG
ATTGGCGN	TATTGGCG
ATTGGCTA	ATGGGCTA
ANGCTTAA	AGGCTTAA
ATTGGGCT	ATGGGCTA
ANGCTTCT	AGCTTCTT
ANGTGGTT	AGGTGGTT
ANTAAGCG	ACTAAGCG
ATTGTATC	ATTATATC
ATTGTCCG	TTGTCCGA
ATTGTGGA	TTTGTGGA
ANATAGCT	AATAGCTT
CAACGGTC	CAAGGTCC
CAACGTCC	CAAGGTCC
CAACGTTC	AAACGTTC
CAACTAAC	AAACTAAC
CAAAACAT	AAAACATG
CAACTAGT	CACTAGTT
CAAAAGAG	CCAAAGAG
CAAAATCC	AAAATCCC
CAAAATGG	CAAATTGG
CAAAATTG	CAAATTGG
CAAAATTT	GAAAATTT
CAACTTCG	CACCTTCG
CAACTTGG	CAAATTGG
ANCTTCTT	AGCTTCTT
ANATGACC	AATGACCG
CAAACATG	AAAACATG
CAAACGTT	AAACGTTC
ANATGTAG	AAATGTAG
CAAACTAA	AAACTAAC
CAAACTGG	CAAATTGG
CAAACTTG	CAAATTGG
CAAAGAGA	CCAAAGAG
CAAAGAGC	CCAAAGAG
CAAAGAGG	CCAAAGAG
CAAAGAGT	CCAAAGAG
CAAAGAGN	CCAAAGAG
CAAAGGTC	CAAGGTCC
CAAAGTCC	CAAGGTCC
CAAAGTGG	CAAATTGG
CAAGAGTC	CAAGGTCC
CAAAGTTG	CAAATTGG
CAAGATAA	CAGATAAT
CAAGATCC	CAAGGTCC
CAAGATCG	TAAGATCG
CAAGATTG	CAAATTGG
CAAATAAT	CAGATAAT
CAAATAGG	CAAATTGG
CAAATATG	CAAATTGG
CAAATCCC	AAAATCCC
CAAATCGG	CAAATTGG
CAAATCTG	CAAATTGG
CAAATGGA	CAAATTGG
CAAATGGC	CAAATTGG
CAAATGGG	CAAATTGG
CAAATGGT	CAAATTGG
CAAATGGN	CAAATTGG
CAAATGTA	AAATGTAG
CAAATGTG	CAAATTGG
CAAATTAG	CAAATTGG
CAAATTCG	CAAATTGG
CAAATTGA	CAAATTGG
CAAATTGC	CAAATTGG
CAAATTGG	CAAATTGG
CAAATTGT	CAAATTGG
CAAATTGN	CAAATTGG
CAAATTTG	CAAATTGG
CAAATTNG	CAAATTGG
CAAGCGTC	CAAGGTCC
CAAATNGG	CAAATTGG
CAAATNTG	CAAATTGG
CAAGCTCC	CAAGGTCC
CAAGGACC	CAAGGTCC
CAAGGATC	CAAGGTCC
CAAGGCCA	CAAGGTCC
CAAGGCCC	CAAGGTCC
CAAGGCCG	CAAGGTCC
CAAGGCCT	CAAGGTCC
CAAGGCCN	CAAGGTCC
CAAANTGG	CAAATTGG
CAAGGCTC	CAAGGTCC
CAAANTTG	CAAATTGG
ANCAAAGG	AGCAAAGG
CAAGGGCC	CAAGGTCC
CAAGGGTA	GAAGGGTA
CAAGGGTC	CAAGGTCC
CAAGGTAC	CAAGGTCC
CAACAACA	TCAACAAC
CAACAACC	TCAACAAC
CAACAACG	TCAACAAC
CAACAACT	TCAACAAC
CAAGGTCA	CAAGGTCC
CAACAACN	TCAACAAC
CAAGGTCC	CAAGGTCC
CAAGGTCG	CAAGGTCC
CAAGGTCT	CAAGGTCC
CAAGGTCN	CAAGGTCC
CAAGGTGC	CAAGGTCC
CAAGGTTC	CAAGGTCC
CAAGGTNC	CAAGGTCC
ANTAGCTT	AATAGCTT
CAAGGNCC	CAAGGTCC
CAAGGNTC	CAAGGTCC
CAACAGAG	CACCAGAG
CAACATTG	CAAATTGG
CAAGTCCA	CAAGGTCC
CAAGTCCC	CAAGGTCC
CAAGTCCG	CAAGGTCC
CAAGTCCT	CAAGGTCC
CAAGTCCN	CAAGGTCC
CACCCAGA	CACCAGAG
ANTATATC	ATTATATC
CAAGTGTC	CAAGGTCC
CAACCAGA	CACCAGAG
CAACCAGC	TAACCAGC
CACCCGAA	ACCCGAAC
CACCCGAG	CACCAGAG
CAAGTTCC	CAAGGTCC
CAAGTTGC	AAGTTGCG
CAAGTTGG	CAAATTGG
CAAGTTTA	CGAGTTTA
CACCCGTC	GACCCGTC
CAACCCTG	AACCCTGG
CACCCTCG	CACCTTCG
CACCCTGG	AACCCTGG
CACCCTTC	CACCTTCG
CAACCTTC	CACCTTCG
CACCGAGA	CACCAGAG
CACCGAGC	CACCAGAG
CACCGAGG	CACCAGAG
CACCGAGT	CACCAGAG
CACCGAGN	CACCAGAG
ANCAGGAC	ACAGGACT
CAGGTAAT	CAGATAAT
CAGGTAGG	CGGGTAGG
CAAGNGTC	CAAGGTCC
CACCGGAG	CACCAGAG
CACNTAGT	CACTAGTT
CAGGTCCA	CAAGGTCC
CAGGTCCC	CAAGGTCC
CAGGTCCG	CAAGGTCC
CAGGTCCT	CAAGGTCC
CAGGTCCN	CAAGGTCC
CAAGNTCC	CAAGGTCC
CACCGTCG	CACCTTCG
CAGGTGGT	AGGTGGTT
CACCGTTC	CACCTTCG
CACNTTCG	CACCTTCG
CACCTACG	CACCTTCG
CACCTAGA	CACCAGAG
CACCTAGT	CACTAGTT
CACCTATC	CACCTTCG
ANTCAACC	ATTCAACC
CACCTCCG	CACCTTCG
CACCTCGA	CACCTTCG
CACCTCGC	CACCTTCG
CACCTCGG	CACCTTCG
CACCTCGT	CACCTTCG
CACCTCGN	CACCTTCG
CACCTCTC	CACCTTCG
CACCTGAG	CACCAGAG
CACCTGCG	CACCTTCG
CACCTGTC	CACCTTCG
CACCTTAC	CACCTTCG
CACCTTAG	CACCTTCG
CACCTTCA	CACCTTCG
CACCTTCC	CACCTTCG
CACCTTCG	CACCTTCG
CACCTTCT	CACCTTCG
CACCTTCN	CACCTTCG
CACCTTGA	CACCTTCG
CACCTTGC	CACCTTCG
CACCTTGG	CACCTTCG
CACCTTGT	CACCTTCG
CACCTTGN	CACCTTCG
CAGCAAAG	AGCAAAGG
CACCTTTC	CACCTTCG
CACCTTTG	CACCTTCG
CACCTTNC	CACCTTCG
CACCTTNG	CACCTTCG
CACCTNCG	CACCTTCG
CACCTNTC	CACCTTCG
ANTGACCG	AATGACCG
CACCNAGA	CACCAGAG
CAGCAGAG	CACCAGAG
CAGCATAA	CAGATAAT
CAGTAATA	CAGATAAT
CAGAAAAT	CAGATAAT
CAGTAATC	CAGATAAT
CAGTAATG	CAGATAAT
CAGTAATT	CAGATAAT
CAGTAATN	CAGATAAT
CACCNGAG	CACCAGAG
CAGAAATA	CAGATAAT
CAGAAATC	CAGATAAT
CAGAAATG	CAGATAAT
CAGAAATT	CAGATAAT
CAGAAATN	CAGATAAT
ANTCCGCC	ATCCGCCA
CACCNTCG	CACCTTCG
ANTCCTGA	ATTCCTGA
CAGTAGTC	CTGTAGTC
CACCNTTC	CACCTTCG
CAGTAGTT	CACTAGTT
CAGCCAGA	CACCAGAG
CAGTATAA	CAGATAAT
CAGAATAA	CAGATAAT
CAGCCCTA	CCGCCCTA
CAGAATTG	CAAATTGG
ANTCGACT	ATCGACTT
CAGNTAAT	CAGATAAT
CACGACGG	CCGACGGA
CAGACAAT	CAGATAAT
CACGAGAG	CACCAGAG
ANTCGGAA	ATCGGAAA
CACGAGTT	CACTAGTT
CAGCCTTC	CACCTTCG
CACGATAA	CAGATAAT
CACGATAC	ACGATACG
CAGTCGGT	GAGTCGGT
CAGACGGA	CCGACGGA
CACTAAGC	ACTAAGCG
CACTAAGT	CACTAGTT
CAGTCTCA	AGTCTCAG
CACTAATT	CACTAGTT
CAGACTAA	CAGATAAT
CACTACGT	CACTAGTT
ANTGGGCT	ATGGGCTA
CACTACTT	CACTAGTT
CACGCAGA	CACCAGAG
CACTAGAG	CACCAGAG
CACTAGAT	CACTAGTT
CACTAGCT	CACTAGTT
CACTAGGT	CACTAGTT
CACTAGTA	CACTAGTT
CACTAGTC	CACTAGTT
ANTCTCAG	AGTCTCAG
CACTAGTG	CACTAGTT
CACTAGTT	CACTAGTT
CACGCCCA	TACGCCCA
CACTAGTN	CACTAGTT
CACGCCCT	CCGCCCTA
CACTAGNT	CACTAGTT
CAGAGAAT	CAGATAAT
CACTATGT	CACTAGTT
CACTATTA	CACTAGTT
CACTATTC	CACTAGTT
CACTATTG	CACTAGTT
CACTATTT	CACTAGTT
CACTATTN	CACTAGTT
CACTANGT	CACTAGTT
CACTANTT	CACTAGTT
CAGAGGCC	AGAGGCCG
CACGCTTC	CACCTTCG
CACTCAGA	CACCAGAG
CACTCAGT	CACTAGTT
CAGAGGTC	CAAGGTCC
CAGAGTAA	CAGATAAT
CACTCCAT	CTCTCCAT
CAGCTAAT	CAGATAAT
CAGAGTTT	CGAGTTTA
CAGCTAGT	CACTAGTT
CAATAATA	CAGATAAT
CAATAATC	CAGATAAT
CAATAATG	CAGATAAT
CAATAATT	CAGATAAT
CAATAATN	CAGATAAT
CACTCGTT	CACTAGTT
CAGATAAA	CAGATAAT
CAGATAAC	CAGATAAT
CAGATAAG	CAGATAAT
CAGATAAT	CAGATAAT
CAGATAAN	CAGATAAT
CAGATACA	CAGATAAT
CAGATACT	CAGATAAT
CAGATAGA	CAGATAAT
CAGATAGT	CAGATAAT
CAGATATA	CAGATAAT
CAGATATC	CAGATAAT
CAGATATG	CAGATAAT
CAGATATT	CAGATAAT
CACTCTTC	CACCTTCG
CAGATATN	CAGATAAT
CAGATANA	CAGATAAT
CACGGGCG	CCGGGCGT
CAGATANT	CAGATAAT
CAGATCAA	CAGATAAT
CAATAGCT	AATAGCTT
CAGATCAT	CAGATAAT
CAATAGTT	CACTAGTT
CACGGTAT	TACGGTAT
CACGGTCC	CAAGGTCC
CAGATGAA	CAGATAAT
CAGATGAT	CAGATAAT
CAGTTAAT	CAGATAAT
CAGCTTCG	CACCTTCG
CAGCTTCT	AGCTTCTT
CAATATTG	CAAATTGG
CACTGAGT	CACTAGTT
CAGATTAA	CAGATAAT
CAGATTAT	CAGATAAT
CAGATTGG	CAAATTGG
CAGATNAA	CAGATAAT
CAGTTGAA	CCGTTGAA
CAGATNAT	CAGATAAT
CACGTAGT	CACTAGTT
CAGTTGCG	AAGTTGCG
CACTGGTA	CCTGGTAC
CACTGGTT	CACTAGTT
CAGTTTAA	CGAGTTTA
CAGTTTAC	CGAGTTTA
CAGANAAT	CAGATAAT
CAGTTTAG	CGAGTTTA
CAGTTTAT	CGAGTTTA
CAGTTTAN	CGAGTTTA
CACTGTTA	CACTAGTT
CACTGTTC	CACTAGTT
CACTGTTG	CACTAGTT
CACTGTTT	CACTAGTT
CACTGTTN	CACTAGTT
CACGTTCG	CACCTTCG
CACGTTGA	CCGTTGAA
CACTTAGT	CACTAGTT
CAGANTAA	CAGATAAT
CACTTCGA	CACCTTCG
CACTTCGC	CACCTTCG
CACTTCGG	CACCTTCG
CACTTCGT	CACCTTCG
CACTTCGN	CACCTTCG
CAATGACC	AATGACCG
CACTTGTT	CACTAGTT
CAATGCAA	CTATGCAA
CACTTTAA	CTCTTTAA
CAGGAACC	CGGGAACC
CATAAGGG	TATAAGGG
CACTTTCG	CACCTTCG
CATAATGA	CTTAATGA
CATAATTG	CAAATTGG
CAGGACTA	ACAGGACT
CAGGACTC	ACAGGACT
CAGGACTG	ACAGGACT
CAGGACTT	ACAGGACT
CAATGGTC	CAAGGTCC
CAGGACTN	ACAGGACT
CAATGTAG	AAATGTAG
CAATGTCC	CAAGGTCC
CACTNAGT	CACTAGTT
CAGGATAA	CAGATAAT
CATACCGG	CTTACCGG
CAATTACA	TAATTACA
CACTNGTT	CACTAGTT
CAGNATAA	CAGATAAT
ANTTATAT	ATTATATC
CAATTCGT	GAATTCGT
CAATTGGA	CAAATTGG
CAATTGGC	CAAATTGG
CAATTGGG	CAAATTGG
CAATTGGT	CAAATTGG
CAATTGGN	CAAATTGG
CAATTGTC	CCATTGTC
ANTTCAAC	ATTCAACC
CCAAGAGA	CCAAAGAG
CCAAGAGC	CCAAAGAG
CCAAGAGG	CCAAAGAG
CCAAGAGT	CCAAAGAG
CCAAGAGN	CCAAAGAG
CAATTTGG	CAAATTGG
CATAGAAA	GATAGAAA
CANGGTCC	CAAGGTCC
ANTTCCTG	ATTCCTGA
CCAAGGAG	CCAAAGAG
CAGGCTTA	AGGCTTAA
CACNAGAG	CACCAGAG
CATAGCTT	AATAGCTT
CCAAGGTC	CAAGGTCC
CACNAGTT	CACTAGTT
CATAGGTC	CAAGGTCC
CAGGGAAC	CGGGAACC
CATAGTTA	CACTAGTT
CATAGTTC	CACTAGTT
CATAGTTG	CACTAGTT
CATAGTTT	CACTAGTT
CATAGTTN	CACTAGTT
CCAATAGA	CCAAAGAG
CAGGGCGT	CCGGGCGT
CACNCAGA	CACCAGAG
CATATAAT	CAGATAAT
CCAATGAG	CCAAAGAG
CAGGGTAG	CGGGTAGG
CAGGGTCC	CAAGGTCC
CCAATGTC	CCATTGTC
CATATGCA	CTATGCAA
CAANTTGG	CAAATTGG
CCAATTGG	CAAATTGG
CCAATTGT	CCATTGTC
CCAATTTA	CCCAATTT
CCAATTTC	CCCAATTT
CCAATTTG	CCCAATTT
CCAATTTT	CCCAATTT
CCAATTTN	CCCAATTT
CACNCTTC	CACCTTCG
CATATTGG	CAAATTGG
CCAANAGA	CCAAAGAG
CANATAAT	CAGATAAT
CCAGAAGA	CCAAAGAG
CAANATTG	CAAATTGG
CCAANGAG	CCAAAGAG
CCAGACGG	CCGACGGA
CCAGAGAG	CCAAAGAG
CCAGATAA	CAGATAAT
CANATTGG	CAAATTGG
CACAAAGA	CCAAAGAG
CCACAAGA	CCAAAGAG
CCACAATT	CCCAATTT
CANTAGTT	CACTAGTT
CCACACCG	CCCACCGT
CCAGCCCT	CCGCCCTA
CACAAGAG	CACCAGAG
CCACAGAG	CCAAAGAG
CACAAGTT	CACTAGTT
CACAATTG	CAAATTGG
CACAATTT	CCCAATTT
CAANGGTC	CAAGGTCC
CCACCAGA	CACCAGAG
CACACAGA	CACCAGAG
CANAATTG	CAAATTGG
CCAGGACT	ACAGGACT
CAANGTCC	CAAGGTCC
CACACCGT	CCCACCGT
CCACCCTA	CCGCCCTA
CCAGGCGT	CCGGGCGT
CANCAGAG	CACCAGAG
CCACCGTA	CCCACCGT
CCACCGTC	CCCACCGT
CCACCGTG	CCCACCGT
CCACCGTT	CCCACCGT
CCACCGTN	CCCACCGT
CCAGGGCG	CCGGGCGT
CCACCTTC	CACCTTCG
CACACTTC	CACCTTCG
CCAGGTAC	CCTGGTAC
CCAGGTCC	CAAGGTCC
CACAGAGA	CACCAGAG
CACAGAGC	CACCAGAG
CACAGAGG	CACCAGAG
CACAGAGT	CACCAGAG
CACAGAGN	CACCAGAG
CANCCAGA	CACCAGAG
CCACGGAA	CCGACGGA
CCACGGAC	CCGACGGA
CCACGGAG	CCGACGGA
CCACGGAT	CCGACGGA
CCACGGAN	CCGACGGA
CACAGGAC	ACAGGACT
CACAGGTC	CAAGGTCC
CCAGTGTC	CCATTGTC
CACAGTTA	CACTAGTT
CACAGTTC	CACTAGTT
CACAGTTG	CACTAGTT
CACAGTTT	CACTAGTT
CACAGTTN	CACTAGTT
CCAGTTGA	CCGTTGAA
CANCCTTC	CACCTTCG
CCAGTTGT	CCATTGTC
CCAGTTTA	CGAGTTTA
CANAGGTC	CAAGGTCC
CATCAGAG	CACCAGAG
CACATAAT	CAGATAAT
CCACTAGT	CACTAGTT
CACATAGT	CACTAGTT
CCACTGTC	CCATTGTC
CACATTAT	GACATTAT
CCACTTGT	CCATTGTC
CATCCAGA	CACCAGAG
CACATTCG	CACCTTCG
CCGAAAGA	CCAAAGAG
CATCCATA	GCATCCAT
CATCCATC	GCATCCAT
CACATTGG	CAAATTGG
CATCCATG	GCATCCAT
CACATTGT	CCATTGTC
CATCCATT	GCATCCAT
CATCCATN	GCATCCAT
CCGAACGG	CCGACGGA
CCGAAGAG	CCAAAGAG
CATCCGCC	ATCCGCCA
CCGAAGGA	CCGACGGA
CCATAAGA	CCAAAGAG
CANCTAGT	CACTAGTT
CATCCTTC	CACCTTCG
CCGAATTT	CCCAATTT
CCCGAACA	ACCCGAAC
CCCGAACC	ACCCGAAC
CCCGAACG	ACCCGAAC
CCCGAACT	ACCCGAAC
CCCGAACN	ACCCGAAC
CCCGAATT	CCCAATTT
CCATAGAG	CCAAAGAG
CCCGACCG	CCCACCGT
CCATAGTC	CCATTGTC
CCCGACGG	CCGACGGA
CATCGACT	ATCGACTT
CCGACAGA	CCGACGGA
CCGACAGG	CCGACGGA
CANCTTCG	CACCTTCG
CCATATGT	CCATTGTC
CCGACCCT	CCGCCCTA
CCGACCGA	CCGACGGA
CCGACCGG	CCGACGGA
CCGACCGT	CCCACCGT
CCGACCTA	CCGCCCTA
CATCGGAA	ATCGGAAA
CCGACGAA	CCGACGGA
CCGACGAC	CCGACGGA
CCGACGAG	CCGACGGA
CCGACGAT	CCGACGGA
CCGACGAN	CCGACGGA
CCGACGCA	CCGACGGA
CCCGATTT	CCCAATTT
CCGACGCG	CCGACGGA
CCGACGGA	CCGACGGA
CCGACGGC	CCGACGGA
CCGACGGG	CCGACGGA
CCGACGGT	CCGACGGA
CCGACGGN	CCGACGGA
CCGACGTA	CCGACGGA
CCGACGTG	CCGACGGA
CCGACGNA	CCGACGGA
CCGACGNG	CCGACGGA
CCGTCCCT	CCGCCCTA
CCGTCCTA	CCGCCCTA
CCGACTGA	CCGACGGA
CCATCCAT	GCATCCAT
CCGACTGG	CCGACGGA
CCGTCGAA	CCGTTGAA
CCGTCGGA	CCGACGGA
CACCAAAG	CACCAGAG
CACCAAGA	CACCAGAG
CACCAAGC	CACCAGAG
CCGACNGA	CCGACGGA
CACCAAGG	CACCAGAG
CACCAAGT	CACCAGAG
CCGACNGG	CCGACGGA
CACCAAGN	CACCAGAG
CACCAATT	CCCAATTT
CCCGCCCT	CCGCCCTA
CCATCGTC	CCATTGTC
CCGTCTGA	CCGTTGAA
CCGTCTGG	TCGTCTGG
CACCACAG	CACCAGAG
CCCGCCGT	CCCACCGT
CACCACCG	CCCACCGT
CACCACGA	CACCAGAG
CCATCTGT	CCATTGTC
CATCTAGT	CACTAGTT
CACCAGAA	CACCAGAG
CACCAGAC	CACCAGAG
CACCAGAG	CACCAGAG
CACCAGAT	CACCAGAG
CACCAGAN	CACCAGAG
CACCAGCA	CACCAGAG
CACCAGCG	CACCAGAG
CACCAGGA	CACCAGAG
CACCAGGC	CACCAGAG
CACCAGGG	CACCAGAG
CCGAGCGG	CCGACGGA
CACCAGGT	CACCAGAG
CCGAGCGT	CCGGGCGT
CACCAGGN	CACCAGAG
CACCAGTA	CACCAGAG
CCGTGAAA	CCGTTGAA
CCGTGAAC	CCGTTGAA
CACCAGTG	CACCAGAG
CCGTGAAG	CCGTTGAA
CATCTCCA	CTCTCCAT
CCGTGAAT	CCGTTGAA
CACCAGTT	CACTAGTT
CCGTGAAN	CCGTTGAA
CACCAGNA	CACCAGAG
CACCAGNG	CACCAGAG
CCGAGGAA	CCGACGGA
CCGAGGAC	CCGACGGA
CCGAGGAG	CCGACGGA
CCGAGGAT	CCGACGGA
CCGAGGAN	CCGACGGA
CACCATAG	CACCAGAG
CCGAGGCG	CCGGGCGT
CCGAGGGA	CCGACGGA
CACCATCG	CACCTTCG
CACCATGA	CACCAGAG
CACCATTC	CACCTTCG
CACCANAG	CACCAGAG
CCGTGCGT	CCGGGCGT
CCGAGTCC	TCGAGTCC
CCATGCAA	CTATGCAA
CACCANGA	CACCAGAG
CCGTGGAA	CCGTTGAA
CCGAGTTT	CGAGTTTA
CCGTGGCG	CCGGGCGT
CATCTTCG	CACCTTCG
CCGTGGTA	CCTGGTAC
CATCTTTA	CTCTTTAA
CCATGGTA	CCTGGTAC
CCATGGTC	CCATTGTC
CCGTGTGA	CCGTTGAA
CCGATAAT	CAGATAAT
CCCGGCGT	CCGGGCGT
CCGTGTTA	GCGTGTTA
CCGATACG	ACGATACG
CCCGGCTA	TCCCGGCT
CCAAAAAG	CCAAAGAG
CCCGGCTC	TCCCGGCT
CCCGGCTG	TCCCGGCT
CANGATAA	CAGATAAT
CCCGGCTT	TCCCGGCT
CCCGGCTN	TCCCGGCT
CCATGTCA	CCATTGTC
CCATGTCC	CCATTGTC
CCAAAAGA	CCAAAGAG
CCATGTCG	CCATTGTC
CCAAAAGC	CCAAAGAG
CCATGTCT	CCATTGTC
CCAAAAGG	CCAAAGAG
CCATGTCN	CCATTGTC
CCAAAAGT	CCAAAGAG
CCAAAAGN	CCAAAGAG
CCATGTGT	CCATTGTC
CCCGGGCG	CCGGGCGT
CATGGGCT	ATGGGCTA
CCAAACAG	CCAAAGAG
CCGATCGG	CCGACGGA
CCGTTAAA	CCGTTGAA
CCGTTAAC	CCGTTGAA
CCGTTAAG	CCGTTGAA
CATGGTAC	CCTGGTAC
CCCGGTAC	CCTGGTAC
CCGTTAAT	CCGTTGAA
CCGTTAAN	CCGTTGAA
CATGGTCC	CAAGGTCC
CCGATGAA	CCGTTGAA
CCGTTAGA	CCGTTGAA
CCAAACGA	CCAAAGAG
CCGATGGA	CCGACGGA
CCGTTCAA	CCGTTGAA
CCAAAGAA	CCAAAGAG
CCAAAGAC	CCAAAGAG
CCAAAGAG	CCAAAGAG
CCGTTCGA	CCGTTGAA
CCAAAGAT	CCAAAGAG
CCAAAGAN	CCAAAGAG
CCAAAGCA	CCAAAGAG
CCGATTGA	CCGTTGAA
CCAAAGCG	CCAAAGAG
CCGATTGT	CCATTGTC
CCAAAGGA	CCAAAGAG
CCGTTGAA	CCGTTGAA
CCAAAGGC	CCAAAGAG
CCGTTGAC	CCGTTGAA
CCAAAGGG	CCAAAGAG
CCGTTGAG	CCGTTGAA
CCAAAGGT	CCAAAGAG
CCGTTGAT	CCGTTGAA
CCAAAGGN	CCAAAGAG
CCGTTGAN	CCGTTGAA
CCAAAGTA	CCAAAGAG
CCGTTGCA	CCGTTGAA
CCAAAGTG	CCAAAGAG
CCAAAGNA	CCAAAGAG
CCGTTGGA	CCGTTGAA
CATGTAGT	CTGTAGTC
CCAAAGNG	CCAAAGAG
CCGTTGTA	CCGTTGAA
CCGTTGTC	CCATTGTC
CCAAATAG	CCAAAGAG
CCGTTGNA	CCGTTGAA
CCAAATGA	CCAAAGAG
CCGTTTAA	CCGTTGAA
CCAAATTG	CAAATTGG
CCAAATTT	CCCAATTT
CCCTGGTA	CCTGGTAC
CCGTTTGA	CCGTTGAA
CCAAANAG	CCAAAGAG
CCGTTNAA	CCGTTGAA
CCAAANGA	CCAAAGAG
CCGTTNGA	CCGTTGAA
CCAACAAC	TCAACAAC
CCGANCGG	CCGACGGA
CCAACAGA	CCAAAGAG
CCCGTTGA	CCGTTGAA
CCGANGGA	CCGACGGA
CCTAAAGA	CCAAAGAG
CCAACCGT	CCCACCGT
CCAACGAG	CCAAAGAG
CATGACCG	AATGACCG
CCGTNGAA	CCGTTGAA
CCAACGGA	CCGACGGA
CCCTTCGA	CACCTTCG
CCCTTCGC	CACCTTCG
CCCTTCGG	CACCTTCG
CCCTTCGT	CACCTTCG
CCCTTCGN	CACCTTCG
CCTAAGAG	CCAAAGAG
CCCTTGAA	CCGTTGAA
CCTAAGCG	ACTAAGCG
CCGTNTGA	CCGTTGAA
CCCTTGTC	CCATTGTC
CCTAATAA	GCCTAATA
CCTAATAC	GCCTAATA
CCTAATAG	GCCTAATA
CCCTTTAA	CTCTTTAA
CCTAATAT	GCCTAATA
CCTAATAN	GCCTAATA
CATGATAA	CAGATAAT
CCGCAATT	CCCAATTT
CCTAATGA	CTTAATGA
CCTAATTT	CCCAATTT
CCGCACCG	CCCACCGT
CCGCACCT	CCGCCCTA
CCGCACGG	CCGACGGA
CCGCACTA	CCGCCCTA
CCGCTCCT	CCGCCCTA
CATGCAAA	CTATGCAA
CATGCAAC	CTATGCAA
CATGCAAG	CTATGCAA
CATGCAAT	CTATGCAA
CCGCTCTA	CCGCCCTA
CATGCAAN	CTATGCAA
CCGNACGG	CCGACGGA
CCGCTGAA	CCGTTGAA
CCTACCGG	CTTACCGG
CCTACCGT	CCCACCGT
CATTAATG	CTTAATGA
CCCTAATA	GCCTAATA
CCCTAATT	CCCAATTT
CCTACGGA	CCGACGGA
CCGCTTGA	CCGTTGAA
CATTACCG	CTTACCGG
CCCTACCG	CCCACCGT
CCGCCACT	CCGCCCTA
CCGCCATA	CCGCCCTA
CCGCCCAA	CCGCCCTA
CCGCCCAC	CCGCCCTA
CCGCCCAG	CCGCCCTA
CCCTAGCG	TCCTAGCG
CCGCCCAT	CCGCCCTA
CCGCCCAN	CCGCCCTA
CCGCCCCA	CCGCCCTA
CCGCCCCT	CCGCCCTA
CCGCCCGA	CCGCCCTA
CATTAGTT	CACTAGTT
CCGCCCGT	CCGCCCTA
CCCTAGTT	CACTAGTT
CCGCCCTA	CCGCCCTA
CCGCCCTC	CCGCCCTA
CCGCCCTG	CCGCCCTA
CCGCCCTT	CCGCCCTA
CCGCCCTN	CCGCCCTA
CCGCCCNA	CCGCCCTA
CATTATAT	ATTATATC
CCGCCCNT	CCGCCCTA
CCGCCGCT	CCGCCCTA
CCGCCGGA	CCGACGGA
CCGCCGGG	GCGCCGGG
CCCTATTT	CCCAATTT
CCGCCGTA	CCGCCCTA
CCGCNCCT	CCGCCCTA
CCGCCTAA	CCGCCCTA
CCGNCCCT	CCGCCCTA
CCGCCTAC	CCGCCCTA
CCGCCTAG	CCGCCCTA
CCGCNCTA	CCGCCCTA
CCGCCTAT	CCGCCCTA
CCGCCTAN	CCGCCCTA
CCCNAATT	CCCAATTT
CCGNCCTA	CCGCCCTA
CCGCCTCT	CCGCCCTA
CCGCCTTA	CCGCCCTA
CATTCAAC	ATTCAACC
CCTAGCGA	TCCTAGCG
CCTAGCGC	TCCTAGCG
CCTAGCGG	TCCTAGCG
CCCNACCG	CCCACCGT
CCTAGCGT	TCCTAGCG
CCTAGCGN	TCCTAGCG
CCTAGCTC	GCTAGCTC
CCGNCGGA	CCGACGGA
CCATTAGT	CCATTGTC
CCGCCNCT	CCGCCCTA
CCATTATC	CCATTGTC
CCGCCNTA	CCGCCCTA
CCTAGGTA	CCTGGTAC
CCCTCCAT	CTCTCCAT
CCGCGAAG	GCGCGAAG
CCTAGTAC	CCTGGTAC
CCCTCCGT	CCCACCGT
CATTCCTG	ATTCCTGA
CCATTCGT	CCATTGTC
CCATTCTC	CCATTGTC
CCTAGTTA	CACTAGTT
CCTAGTTC	CACTAGTT
CCATTGAA	CCGTTGAA
CCTAGTTG	CACTAGTT
CCTAGTTT	CACTAGTT
CCATTGAC	CCATTGTC
CCTAGTTN	CACTAGTT
CCATTGAT	CCATTGTC
CCATTGCA	CCATTGTC
CCGCGCCT	CCGCCCTA
CCCNATTT	CCCAATTT
CCATTGCC	CCATTGTC
CCATTGCG	CCATTGTC
CCATTGCT	CCATTGTC
CCATTGCN	CCATTGTC
CCGCGCGT	CCGGGCGT
CCATTGGC	CCATTGTC
CCGCGCTA	CCGCCCTA
CCATTGGT	CCATTGTC
CCATTGTA	CCATTGTC
CCGGAACC	CGGGAACC
CCATTGTC	CCATTGTC
CCATTGTG	CCATTGTC
CCATTGTT	CCATTGTC
CCATTGTN	CCATTGTC
CCGCGGAA	CCGACGGA
CCATTGNC	CCATTGTC
CCGCGGAC	CCGACGGA
CCGCGGAG	CCGACGGA
CCGCGGAT	CCGACGGA
CCATTGNT	CCATTGTC
CCGCGGAN	CCGACGGA
CCCTCTCT	TCCTCTCT
CCGCGGCG	CCGGGCGT
CCATTTCA	CCATTGTC
CCATTTCC	CCATTGTC
CCATTTCG	CCATTGTC
CCATTTCT	CCATTGTC
CCATTTCN	CCATTGTC
CCATTTGT	CCATTGTC
CCATTTTC	CCATTGTC
CCGGACGG	CCGACGGA
CCGNGCGT	CCGGGCGT
CCGGACGT	CCGGGCGT
CCGNGGCG	CCGGGCGT
CCATTNGT	CCATTGTC
CCCNCCGT	CCCACCGT
CCATTNTC	CCATTGTC
CCTATGCA	CTATGCAA
CCGGAGCG	CCGGGCGT
CATTGGCG	TATTGGCG
CCTATTGT	CCATTGTC
CATTGTCA	CCATTGTC
CATTGTCC	CCATTGTC
CATTGTCG	CCATTGTC
CATTGTCT	CCATTGTC
CATTGTCN	CCATTGTC
CCATNGTC	CCATTGTC
CCGNTGAA	CCGTTGAA
CCATNTGT	CCATTGTC
CATTTCCC	GATTTCCC
CCGNTTGA	CCGTTGAA
CCANAAGA	CCAAAGAG
CCANAGAG	CCAAAGAG
CCTCAATT	CCCAATTT
CCGGCCCT	CCGCCCTA
CCTCACCG	CCCACCGT
CCGGCCGT	CCGGGCGT
CCGGCCTA	CCGCCCTA
CCNAAAGA	CCAAAGAG
CCGGCGCG	CCGGGCGT
CCGGCGGA	CCGACGGA
CGACATTA	GACATTAT
CCGGCGTA	CCGGGCGT
CCGGCGTC	CCGGGCGT
CCGGCGTG	CCGGGCGT
CCGGCGTT	CCGGGCGT
CCNAAGAG	CCAAAGAG
CCGGCGTN	CCGGGCGT
CCCACACG	CCCACCGT
CGACCAGA	CACCAGAG
CCCACAGT	CCCACCGT
CCCACATT	CCCAATTT
CCNAATTT	CCCAATTT
CCCACCAG	CCCACCGT
CCCACCAT	CCCACCGT
CCCACCCG	CCCACCGT
CCTCCATA	CTCTCCAT
CCCACCCT	CCCACCGT
CCTCCATC	CTCTCCAT
CCCACCGA	CCCACCGT
CCTCCATG	CTCTCCAT
CCCACCGC	CCCACCGT
CCTCCATT	CTCTCCAT
CCCACCGG	CCCACCGT
CCTCCATN	CTCTCCAT
CCCACCGT	CCCACCGT
CCCACCGN	CCCACCGT
CCCACCTA	CCCACCGT
CGACCCGT	GACCCGTC
CCCACCTC	CCCACCGT
CCCACCTG	CCCACCGT
CCCACCTT	CCCACCGT
CCCACCTN	CCCACCGT
CCCACCNG	CCCACCGT
CCCACCNT	CCCACCGT
CCCACGCG	CCCACCGT
CCCACGGA	CCGACGGA
CCCACGGT	CCCACCGT
CCCACGTA	CCCACCGT
CCCACGTC	CCCACCGT
CCCACGTG	CCCACCGT
CCCACGTT	CCCACCGT
CCCACGTN	CCCACCGT
CCCACTCG	CCCACCGT
CCTCCCTA	CCGCCCTA
CCGGGAAC	CGGGAACC
CCCACTGT	CCCACCGT
CCGGGACG	CCGGGCGT
CCCACTTT	CCCAATTT
CCGGGAGT	CCGGGCGT
CCNACCGT	CCCACCGT
CGACCTTC	CACCTTCG
CCCACNCG	CCCACCGT
CCGGGCAG	CCGGGCGT
CCCACNGT	CCCACCGT
CCGGGCAT	CCGGGCGT
CCNACGGA	CCGACGGA
CCCAGAGA	CACCAGAG
CCCAGAGC	CACCAGAG
CCCAGAGG	CACCAGAG
CCCAGAGT	CACCAGAG
CCCAGAGN	CACCAGAG
CCGGGCCG	CCGGGCGT
CCGGGCCT	CCGGGCGT
CCCAGATT	CCCAATTT
CCGGGCGA	CCGGGCGT
CCGGGCGC	CCGGGCGT
CCGGGCGG	CCGGGCGT
CCGGGCGT	CCGGGCGT
CCGGGCGN	CCGGGCGT
CCGGGCTA	CCGGGCGT
CCGGGCTC	CCGGGCGT
CCGGGCTG	CCGGGCGT
CCGGGCTT	CCGGGCGT
CCGGGCTN	CCGGGCGT
CCNTGGTA	CCTGGTAC
CCGGGCNG	CCGGGCGT
CCCAGCCG	CCCACCGT
CCGGGCNT	CCGGGCGT
CCCAGCGT	CCCACCGT
CCGGGGCG	CCGGGCGT
CGAGTAGG	CGGGTAGG
CGAGTATA	CGAGTTTA
CGAGTATT	CGAGTTTA
CCGGGGGT	CCGGGCGT
CCGGGGTA	CCGGGCGT
CCGGGGTC	CCGGGCGT
CCGGGGTG	CCGGGCGT
CCGGGGTT	CCGGGCGT
CGACGGAA	CCGACGGA
CCGGGGTN	CCGGGCGT
CGACGGAC	CCGACGGA
CGACGGAG	CCGACGGA
CGACGGAT	CCGACGGA
CGACGGAN	CCGACGGA
CGAGTCCA	TCGAGTCC
CGAGTCCC	TCGAGTCC
CCGGGTAC	CCTGGTAC
CGAGTCCG	TCGAGTCC
CCGGGTAG	CGGGTAGG
CGAGTCCT	TCGAGTCC
CGAGTCCN	TCGAGTCC
CCNCCCTA	CCGCCCTA
CGAGTCGG	GAGTCGGT
CCGGGTCG	CCGGGCGT
CCCAGTTT	CCCAATTT
CGAGTCTA	CGAGTTTA
CGAGTCTT	CGAGTTTA
CCGGGTGT	CCGGGCGT
CGAGTGTA	CGAGTTTA
CGACGTTT	CGAGTTTA
CGAGTGTT	CGAGTTTA
CGAGTTAA	CGAGTTTA
CGAGTTAC	CGAGTTTA
CGAGTTAG	CGAGTTTA
CGAGTTAT	CGAGTTTA
CGAGTTAN	CGAGTTTA
CGAGTTCA	CGAGTTTA
CCGGGNCG	CCGGGCGT
CGAGTTCT	CGAGTTTA
CCCATATT	CCCAATTT
CGAGTTGA	CGAGTTTA
CCGGGNGT	CCGGGCGT
CGAGTTGT	CGAGTTTA
CGAGTTTA	CGAGTTTA
CGAGTTTC	CGAGTTTA
CCNTTGAA	CCGTTGAA
CGAGTTTG	CGAGTTTA
CGAGTTTT	CGAGTTTA
CGAGTTTN	CGAGTTTA
CGAGTTNA	CGAGTTTA
CCCATCCG	CCCACCGT
CGAGTTNT	CGAGTTTA
CCCATCGT	CCCACCGT
CCNTTGTC	CCATTGTC
CGACTAGT	CACTAGTT
CGAGTNTA	CGAGTTTA
CGAGTNTT	CGAGTTTA
CCGGTACA	CCTGGTAC
CCCATTGT	CCATTGTC
CCGGTACC	CCTGGTAC
CCGGTACG	CCTGGTAC
CCCATTTA	CCCAATTT
CCGGTACT	CCTGGTAC
CCCATTTC	CCCAATTT
CCGGTACN	CCTGGTAC
CCCATTTG	CCCAATTT
CCCATTTT	CCCAATTT
CCCATTTN	CCCAATTT
CCGGTAGG	CGGGTAGG
CGACTTTA	CGAGTTTA
CCANTGTC	CCATTGTC
CCCANATT	CCCAATTT
CCGGTCGT	CCGGGCGT
CGAGNTTA	CGAGTTTA
CCGGTGAA	CCGTTGAA
CGAGNTTT	CGAGTTTA
CCCANCCG	CCCACCGT
CCANTTGT	CCATTGTC
CCCANCGT	CCCACCGT
CCNATTGT	CCATTGTC
CGATAATA	CAGATAAT
CGATAATC	CAGATAAT
CGATAATG	CAGATAAT
CGATAATT	CAGATAAT
CGATAATN	CAGATAAT
CCGGTGCG	CCGGGCGT
CCCANTTT	CCCAATTT
CGATACGA	ACGATACG
CGATACGC	ACGATACG
CGATACGG	ACGATACG
CGATACGT	ACGATACG
CGATACGN	ACGATACG
CGATAGAA	GATAGAAA
CCGGTTGA	CCGTTGAA
CCCCAATT	CCCAATTT
CCCCACCG	CCCACCGT
CGAGAACC	CGGGAACC
CCGGNCGT	CCGGGCGT
CCGGNGCG	CCGGGCGT
CCCCAGAG	CACCAGAG
CCCAAAGA	CCAAAGAG
CCNCAATT	CCCAATTT
CCCAAATT	CCCAATTT
CGAGATAA	CAGATAAT
CCNCACCG	CCCACCGT
CCCAACCG	CCCACCGT
CCCAACGT	CCCACCGT
CGAGATTA	CGAGTTTA
CCCAACTT	CCCAATTT
CGAGATTT	CGAGTTTA
CCCAAGAG	CCAAAGAG
CCCAAGTT	CCCAATTT
CCCAATAT	CCCAATTT
CCCAATCT	CCCAATTT
CCCCATTT	CCCAATTT
CCCAATGT	CCCAATTT
CCCAATTA	CCCAATTT
CCCAATTC	CCCAATTT
CCCAATTG	CCCAATTT
CCCAATTT	CCCAATTT
CCCAATTN	CCCAATTT
CCCAATNT	CCCAATTT
CCGTACGG	CCGACGGA
CCCAANTT	CCCAATTT
CGATGCAA	CTATGCAA
CGCGGAAC	CGGGAACC
CCGTAGAA	CCGTTGAA
CCNGACGG	CCGACGGA
CCGTAGTC	CTGTAGTC
CGGATAAT	CAGATAAT
CGGATAGG	CGGGTAGG
CCGTATGA	CCGTTGAA
CGCGGGCG	CCGGGCGT
CGAGCTTA	CGAGTTTA
CGAGCTTT	CGAGTTTA
CGATGTTT	CGAGTTTA
CCTCGGTA	CCTGGTAC
CGCGGTAG	CGGGTAGG
CCTCGTAC	CCTGGTAC
CGAGGAAC	CGGGAACC
CCCCCCGT	CCCACCGT
CCCCCCTA	CCGCCCTA
CGAGGCAT	TGAGGCAT
CGAGGCCG	AGAGGCCG
CCNGCCCT	CCGCCCTA
CGCGTAGG	CGGGTAGG
CCTCTCCA	CTCTCCAT
CCCCCGTA	CCCACCGT
CCCCCGTC	CCCACCGT
CCCCCGTG	CCCACCGT
CGATTGTC	CCATTGTC
CCCCCGTT	CCCACCGT
CCCCCGTN	CCCACCGT
CGAGGTAG	CGGGTAGG
CCTCTCTA	TCCTCTCT
CCTCTCTC	TCCTCTCT
CCTCTCTG	TCCTCTCT
CGATTTAA	CGAGTTTA
CCTCTCTT	TCCTCTCT
CGAGGTCC	CAAGGTCC
CGATTTAC	CGAGTTTA
CCTCTCTN	TCCTCTCT
CGATTTAG	CGAGTTTA
CGATTTAT	CGAGTTTA
CCCCCTAA	CCGCCCTA
CGATTTAN	CGAGTTTA
CCCCCTAC	CCGCCCTA
CCCCCTAG	CCGCCCTA
CGATTTCC	GATTTCCC
CGAGGTTA	CGAGTTTA
CGAGGTTT	CGAGTTTA
CGATTTTA	CGAGTTTA
CGCGTGTT	GCGTGTTA
CCCCCTAT	CCGCCCTA
CCCCCTAN	CCGCCCTA
CGCGTTGA	CCGTTGAA
CGCGTTTA	CGAGTTTA
CCTCTTTA	CTCTTTAA
CCNGGCGT	CCGGGCGT
CGGCAACC	CGGGAACC
CCCCGAAC	ACCCGAAC
CCNGGGCG	CCGGGCGT
CCNGGTAC	CCTGGTAC
CGGNAACC	CGGGAACC
CGCTAAAT	TGCTAAAT
CCCCGGCT	TCCCGGCT
CCTGACGG	CCGACGGA
CGGCCCTA	CCGCCCTA
CGCTAGCT	GCTAGCTC
CGAAAATT	GAAAATTT
CCNGTTGA	CCGTTGAA
CGCTAGTT	CACTAGTT
CCTGAGTA	CCTGGTAC
CGAAAGAG	CCAAAGAG
CCTGATAC	CCTGGTAC
CGAAATTG	CAAATTGG
CGGCGAAC	CGGGAACC
CGCTCCAT	CTCTCCAT
CCTGCCCT	CCGCCCTA
CGTAGTCA	CTGTAGTC
CGTAGTCC	CTGTAGTC
CGTAGTCG	CTGTAGTC
CGTAGTCT	CTGTAGTC
CGTAGTCN	CTGTAGTC
CGTAGTTT	CGAGTTTA
CCTGCGTA	CCTGGTAC
CGGCGTAG	CGGGTAGG
CCTGCTAC	CCTGGTAC
CGGNGAAC	CGGGAACC
CGAAGGGT	GAAGGGTA
CGAAGGTC	CAAGGTCC
CCTGGAAC	CCTGGTAC
CCTGGACA	CCTGGTAC
CCTGGACC	CCTGGTAC
CCTGGACG	CCTGGTAC
CCTGGACT	CCTGGTAC
CCCCTTCG	CACCTTCG
CCTGGACN	CCTGGTAC
CGGCTAGG	CGGGTAGG
CGTATGCA	CTATGCAA
CGAAGTTT	CGAGTTTA
CCTGGATA	CCTGGTAC
CCTGGCAC	CCTGGTAC
CGGNGTAG	CGGGTAGG
CCTGGCGT	CCGGGCGT
CCTGGCTA	CCTGGTAC
CCTGGGAC	CCTGGTAC
CCTGGGCG	CCGGGCGT
CCTGGGTA	CCTGGTAC
CGGCTTAA	AGGCTTAA
CCTGGTAA	CCTGGTAC
CCTGGTAC	CCTGGTAC
CCTGGTAG	CCTGGTAC
CCTGGTAT	CCTGGTAC
CCTGGTAN	CCTGGTAC
CCTGGTCA	CCTGGTAC
CCTGGTCC	CCTGGTAC
CCTGGTCG	CCTGGTAC
CCTGGTCT	CCTGGTAC
CCTGGTCN	CCTGGTAC
CCTGGTGA	CCTGGTAC
CCTGGTGC	CCTGGTAC
CGCTGGTA	CCTGGTAC
CCTGGTTA	CCTGGTAC
CCTGGTTC	CCTGGTAC
CGGNTAGG	CGGGTAGG
CCTGGTNA	CCTGGTAC
CCTGGTNC	CCTGGTAC
CCTGGNAC	CCTGGTAC
CCTTAATG	CTTAATGA
CGAATTCG	GAATTCGT
CCTGGNTA	CCTGGTAC
CGAATTGG	CAAATTGG
CGAATTTA	CGAGTTTA
CCTGTACA	CCTGGTAC
CCTGTACC	CCTGGTAC
CCTGTACG	CCTGGTAC
CCTGTACT	CCTGGTAC
CCTGTACN	CCTGGTAC
CCTGTAGT	CTGTAGTC
CCTTACCG	CTTACCGG
CGCTTCTT	AGCTTCTT
CCTGTGTA	CCTGGTAC
CCTGTTAC	CCTGGTAC
CGTCAAAT	GTCAAATG
CCTGTTGA	CCGTTGAA
CGCTTTAA	CTCTTTAA
CGGGAAAC	CGGGAACC
CGGGAACA	CGGGAACC
CGGGAACC	CGGGAACC
CGGGAACG	CGGGAACC
CGGGAACT	CGGGAACC
CGGGAACN	CGGGAACC
CGGGAAGC	CGGGAACC
CGGGAAGG	CGGGTAGG
CGGGAATC	CGGGAACC
CGGGCAAC	CGGGAACC
CGTCAGGC	GTCAGGCT
CGGGAANC	CGGGAACC
CGGGCACC	CGGGAACC
CGGGACAC	CGGGAACC
CGGGCAGG	CGGGTAGG
CGGGACCA	CGGGAACC
CGGGACCC	CGGGAACC
CGGGACCG	CGGGAACC
CGGGACCT	CGGGAACC
CGGGACCN	CGGGAACC
CGGGAGAC	CGGGAACC
CGGGAGCC	CGGGAACC
CGGGAGGA	CGGGTAGG
CGGGAGGC	CGGGTAGG
CGGGAGGG	CGGGTAGG
CGGGAGGT	CGGGTAGG
CGGGAGGN	CGGGTAGG
CCTGNGTA	CCTGGTAC
CGGGCGTA	CCGGGCGT
CGGGCGTC	CCGGGCGT
CGGGATAC	CGGGAACC
CGGGCGTG	CCGGGCGT
CGGGATAG	CGGGTAGG
CGGGCGTT	CCGGGCGT
CGGGCGTN	CCGGGCGT
CGGGATCC	CGGGAACC
CCTGNTAC	CCTGGTAC
CGGGCTAG	CGGGTAGG
CGGGANAC	CGGGAACC
CGGGANCC	CGGGAACC
CGGGGAAC	CGGGAACC
CGGGGACC	CGGGAACC
CGGGGAGG	CGGGTAGG
CGGGGCGT	CCGGGCGT
CGGGGTAG	CGGGTAGG
CGTAATGA	CTTAATGA
CGGGTAAC	CGGGAACC
CGGGTAAG	CGGGTAGG
CGGGTACC	CGGGAACC
CGGGTACG	CGGGTAGG
CGGGTAGA	CGGGTAGG
CGGGTAGC	CGGGTAGG
CGGGTAGG	CGGGTAGG
CGGGTAGT	CGGGTAGG
CGGGTAGN	CGGGTAGG
CGGGTATG	CGGGTAGG
CGGGTANG	CGGGTAGG
CGGGTCAG	CGGGTAGG
CGGGTCGG	CGGGTAGG
CGGGTGAG	CGGGTAGG
CGGGTGGA	CGGGTAGG
CGGGTGGC	CGGGTAGG
CGGGTGGG	CGGGTAGG
CGGGTGGT	CGGGTAGG
CGGGTGGN	CGGGTAGG
CGTACCGA	GTACCGAA
CGTACCGG	CTTACCGG
CGGGTTAG	CGGGTAGG
CGGGTTGG	CGGGTAGG
CGGGTTTA	CGAGTTTA
CGGGTNAG	CGGGTAGG
CCTTGAAA	CCGTTGAA
CGGGTNGG	CGGGTAGG
CCTTGAAC	CCGTTGAA
CCTTGAAG	CCGTTGAA
CCTTGAAT	CCGTTGAA
CCTTGAAN	CCGTTGAA
CGGGNAAC	CGGGAACC
CGGGNACC	CGGGAACC
CGGGNAGG	CGGGTAGG
CGANGTTT	CGAGTTTA
CGTCTCAG	AGTCTCAG
CGTCTCCA	CTCTCCAT
CGGAAACC	CGGGAACC
CGNAGTTT	CGAGTTTA
CGTCTGGA	TCGTCTGG
CGTCTGGC	TCGTCTGG
CGTCTGGG	TCGTCTGG
CGTCTGGT	TCGTCTGG
CCTTGGTA	CCTGGTAC
CGTCTGGN	TCGTCTGG
CCTTGTAC	CCTGGTAC
CTACTAGT	CACTAGTT
CCTTGTCA	CCATTGTC
CGGGNTAG	CGGGTAGG
CCTTGTCC	CCATTGTC
CCTTGTCG	CCATTGTC
CCTTGTCT	CCATTGTC
CGGAACCA	CGGGAACC
CGGAACCC	CGGGAACC
CCTTGTCN	CCATTGTC
CGGAACCG	CGGGAACC
CGGAACCT	CGGGAACC
CGGAACCN	CGGGAACC
CGTCTTTA	CTCTTTAA
CTACTCCA	CTCTCCAT
CCTTTAAA	CTCTTTAA
CCTTTAAC	CTCTTTAA
CCTTTAAG	CTCTTTAA
CTACTGCA	CTATGCAA
CCTTTAAT	CTCTTTAA
CGGTAACC	CGGGAACC
CCTTTAAN	CTCTTTAA
CGANTTTA	CGAGTTTA
CTACTTTA	CTCTTTAA
CCTTTGAA	CCGTTGAA
CGGTAGGA	CGGGTAGG
CGGTAGGC	CGGGTAGG
CGGTAGGG	CGGGTAGG
CGGTAGGT	CGGGTAGG
CGGTAGGN	CGGGTAGG
CGGTAGTC	CTGTAGTC
CCTTTGTC	CCATTGTC
CTATCAAA	CTATGCAA
CTATCAAC	CTATGCAA
CTATCAAG	CTATGCAA
CTATCAAT	CTATGCAA
CTATCAAN	CTATGCAA
CTATCACT	TTATCACT
CTATCCAA	CTATGCAA
CTATCCAT	CTCTCCAT
CGCAAAGA	CCAAAGAG
CGCAAAGG	AGCAAAGG
CGGTGAAC	CGGGAACC
CTATCGCA	CTATGCAA
CGGACGGA	CCGACGGA
CGCAATTT	CCCAATTT
CGGTGGTT	AGGTGGTT
CGGTGTAG	CGGGTAGG
CTATGAAA	CTATGCAA
CTATGAAC	CTATGCAA
CTATGAAG	CTATGCAA
CTATGAAT	CTATGCAA
CTATGAAN	CTATGCAA
CTATGACA	CTATGCAA
CGGAGAAC	CGGGAACC
CTAGATAA	CAGATAAT
CGGAGACT	TGGAGACT
CTATGCAA	CTATGCAA
CTATGCAC	CTATGCAA
CTATGCAG	CTATGCAA
CTATGCAT	CTATGCAA
CTATGCAN	CTATGCAA
CTATGCCA	CTATGCAA
CTATGCGA	CTATGCAA
CTATGCTA	CTATGCAA
CTATGCNA	CTATGCAA
CGGTTAGG	CGGGTAGG
CTATGGAA	CTATGCAA
CTATGGCA	CTATGCAA
CGCACCGT	CCCACCGT
CTAGCAAA	CTATGCAA
CTAGCAAC	CTATGCAA
CTATGTAA	CTATGCAA
CTAGCAAG	CTATGCAA
CTAGCAAT	CTATGCAA
CTAGCAAN	CTATGCAA
CTATGTCA	CTATGCAA
CGGTTGAA	CCGTTGAA
CGGAGTAG	CGGGTAGG
CTATGNAA	CTATGCAA
CTATGNCA	CTATGCAA
CGGTTTAA	CGAGTTTA
CGGTTTAC	CGAGTTTA
CGGTTTAG	CGAGTTTA
CGGAGTTT	CGAGTTTA
CGGTTTAT	CGAGTTTA
CGGTTTAN	CGAGTTTA
CTATTCAA	CTATGCAA
CTAGCTCA	GCTAGCTC
CTAGCTCC	GCTAGCTC
CTAGCTCG	GCTAGCTC
CTAGCTCT	GCTAGCTC
CTAGCTCN	GCTAGCTC
CTATTGCA	CTATGCAA
CTATTGGC	TATTGGCG
CTATTGTC	CCATTGTC
CTAAAGAG	CCAAAGAG
CTATTTAA	CTCTTTAA
CTAGGACG	TTAGGACG
CTAAATGA	CTTAATGA
CTAAATTG	CAAATTGG
CGCAGTTT	CGAGTTTA
CTAGGCAA	CTATGCAA
CGNGAACC	CGGGAACC
CTATNCAA	CTATGCAA
CTAACCAG	TAACCAGC
CTAACCGG	CTTACCGG
CGCATCCA	GCATCCAT
CTATNGCA	CTATGCAA
CTAGGTCC	CAAGGTCC
CGCATTGT	CCATTGTC
CTAGTAGT	CTGTAGTC
CTAAGATC	TAAGATCG
CTAAGCAA	CTATGCAA
CGTGAACC	CGGGAACC
CTGCCATG	TGCCATGT
CTAAGCGA	ACTAAGCG
CTAAGCGC	ACTAAGCG
CTAAGCGG	ACTAAGCG
CTAAGCGT	ACTAAGCG
CTAAGCGN	ACTAAGCG
CTAGTGCA	CTATGCAA
CTGCCCTA	CCGCCCTA
CTAAGGTC	CAAGGTCC
CTAGTTTA	CGAGTTTA
CGNGGAAC	CGGGAACC
CCTNGGTA	CCTGGTAC
CCTNGTAC	CCTGGTAC
CTCTAATG	CTTAATGA
CTAATGAA	CTTAATGA
CTAATGAC	CTTAATGA
CTAATGAG	CTTAATGA
CTAATGAT	CTTAATGA
CTAATGAN	CTTAATGA
CTAATGCA	CTATGCAA
CTCTACAT	CTCTCCAT
CTCTACCA	CTCTCCAT
CTCTACCG	CTTACCGG
CTAATTAC	TAATTACA
CTAATTGG	CAAATTGG
CGNGGTAG	CGGGTAGG
CTCTAGTC	CTGTAGTC
CTGCGTTC	TTGCGTTC
CTCTAGTT	CACTAGTT
CGNGTAGG	CGGGTAGG
CTCTATAA	CTCTTTAA
CTGCTAAA	TGCTAAAT
CTANGCAA	CTATGCAA
CTCTATTA	CTCTTTAA
CTATAAGG	TATAAGGG
CTGCTAGT	CTGTAGTC
CTATAATG	CTTAATGA
CTATACAA	CTATGCAA
CTATACCG	CTTACCGG
CTGCTCCA	CTCTCCAT
CGNGTTTA	CGAGTTTA
CTATAGCA	CTATGCAA
CTATAGTC	CTGTAGTC
CGTGGAAC	CGGGAACC
CTGCTTTA	CTCTTTAA
CTCTCAAT	CTCTCCAT
CTCTCACA	CTCTCCAT
CGCCAATT	CCCAATTT
CGTGGCAC	GTGGCACC
CGCCACCG	CCCACCGT
CTCTCATA	CTCTCCAT
CTCTCATC	CTCTCCAT
CTCTCATG	CTCTCCAT
CTCTCATT	CTCTCCAT
CTCTCATN	CTCTCCAT
CTCTCCAA	CTCTCCAT
CTCTCCAC	CTCTCCAT
CGCCAGAG	CACCAGAG
CTCTCCAG	CTCTCCAT
CTCTCCAT	CTCTCCAT
CTCTCCAN	CTCTCCAT
CTCTCCCA	CTCTCCAT
CTCTCCCT	CTCTCCAT
CGTGGGGT	TGTGGGGT
CTCTCCGA	CTCTCCAT
CTANTGCA	CTATGCAA
CGTGGTAC	CCTGGTAC
CGTGGTAG	CGGGTAGG
CTCTCCGT	CTCTCCAT
CTCTCCTA	CTCTCCAT
CTCTCCTC	CTCTCCAT
CTCTCCTG	CTCTCCAT
CTCTCCTT	CTCTCCAT
CTCTCCTN	CTCTCCAT
CTCTCCNA	CTCTCCAT
CGCCATGT	TGCCATGT
CTCTCCNT	CTCTCCAT
CTCTCGAT	CTCTCCAT
CTCTCGCA	CTCTCCAT
CTCTCTAA	CTCTTTAA
CTCTCTAT	CTCTCCAT
CTCTCTCA	CTCTCCAT
CTACCAGA	CACCAGAG
CGTGTAGG	CGGGTAGG
CGTGTAGT	CTGTAGTC
CTCTCTTA	CTCTTTAA
CTTCAACC	ATTCAACC
CTTCAATG	CTTAATGA
CTCTCNAT	CTCTCCAT
CTCTCNCA	CTCTCCAT
CTTCACCG	CTTACCGG
CTGNTAGT	CTGTAGTC
CTACCGAA	GTACCGAA
CTGGAACC	CGGGAACC
CTACCGGA	CTTACCGG
CTACCGGC	CTTACCGG
CTACCGGG	CTTACCGG
CTACCGGT	CTTACCGG
CTACCGGN	CTTACCGG
CGTGTTAA	GCGTGTTA
CGTGTTAC	GCGTGTTA
CGTGTTAG	GCGTGTTA
CGTGTTAT	GCGTGTTA
CGTGTTAN	GCGTGTTA
CTACCTTC	CACCTTCG
CGCCCTAA	CCGCCCTA
CGCCCTAC	CCGCCCTA
CGCCCTAG	CCGCCCTA
CGCCCTAT	CCGCCCTA
CTTCATGA	CTTAATGA
CGCCCTAN	CCGCCCTA
CGTGTTTA	CGAGTTTA
CTGGAGAC	TGGAGACT
CTCTGCAA	CTATGCAA
CTCTGCAT	CTCTCCAT
CTCTGCCA	CTCTCCAT
CTGGAGTC	CTGTAGTC
CTTCCAAA	TTCCAAAA
CTCTGGTA	CCTGGTAC
CTACGCAA	CTATGCAA
CTTCCATA	CTCTCCAT
CTTCCATC	CTCTCCAT
CTCTGTAA	CTCTTTAA
CTTCCATG	CTCTCCAT
CTTCCATT	CTCTCCAT
CTACGCCC	TACGCCCA
CTTCCATN	CTCTCCAT
CTCTGTTA	CTCTTTAA
CTTCCCGG	CTTACCGG
CTACGGTA	TACGGTAT
CTGGCACC	GTGGCACC
CTTCCGGA	CTTACCGG
CTCTTAAA	CTCTTTAA
CTTCCGGC	CTTACCGG
CTCTTAAC	CTCTTTAA
CTTCCGGG	CTTACCGG
CTCTTAAG	CTCTTTAA
CTTCCGGT	CTTACCGG
CTCTTAAT	CTCTTTAA
CTTCCGGN	CTTACCGG
CTCTTAAN	CTCTTTAA
CTCTTATA	CTCTTTAA
CTCTTCAA	CTCTTTAA
CTTCCTGA	ATTCCTGA
CTCTTCAT	CTCTCCAT
CTCTTCCA	CTCTCCAT
CTCTTCTA	CTCTTTAA
CTCTTGAA	CTCTTTAA
CGCCGGGA	GCGCCGGG
CGCCGGGC	GCGCCGGG
CGCCGGGG	GCGCCGGG
CGCCGGGT	GCGCCGGG
CTCTTGTA	CTCTTTAA
CGCCGGGN	GCGCCGGG
CTCTTTAA	CTCTTTAA
CTCTTTAC	CTCTTTAA
CTCTTTAG	CTCTTTAA
CTCTTTAT	CTCTTTAA
CTCTTTAN	CTCTTTAA
CTCTTTCA	CTCTTTAA
CTCTTTGA	CTCTTTAA
CTCTTTTA	CTCTTTAA
CGTTAATG	CTTAATGA
CTCTTTNA	CTCTTTAA
CTCTTNAA	CTCTTTAA
CTTAAAGA	CTTAATGA
CGTTACCG	CTTACCGG
CTCTTNTA	CTCTTTAA
CTTAAATG	CTTAATGA
CTTAACCG	CTTACCGG
CTTAACGA	CTTAATGA
CTTAACGG	CTTACCGG
CTTAACTG	CTTAATGA
CGCCTAAT	GCCTAATA
CTGGGAAC	CGGGAACC
CTCTNCAT	CTCTCCAT
CTTAAGAA	CTTAATGA
CTCTNCCA	CTCTCCAT
CTTAAGAC	CTTAATGA
CTTAAGAG	CTTAATGA
CTTAAGAT	CTTAATGA
CTTAAGAN	CTTAATGA
CTTAAGGA	CTTAATGA
CTTAAGTG	CTTAATGA
CTTAATAA	CTTAATGA
CTTAATAC	CTTAATGA
CTTAATAG	CTTAATGA
CTTAATAT	CTTAATGA
CTTAATAN	CTTAATGA
CTTAATCA	CTTAATGA
CTTAATCG	CTTAATGA
CTTAATGA	CTTAATGA
CTTAATGC	CTTAATGA
CTTAATGG	CTTAATGA
CTTAATGT	CTTAATGA
CTTAATGN	CTTAATGA
CTGGGCGT	CCGGGCGT
CTTAATTA	CTTAATGA
CTCTNTAA	CTCTTTAA
CTGGGCTA	ATGGGCTA
CTTAATTG	CTTAATGA
CTTAATNA	CTTAATGA
CTTAATNG	CTTAATGA
CTCTNTTA	CTCTTTAA
CTGTAAGT	CTGTAGTC
CTGTAATC	CTGTAGTC
CTGTAATG	CTTAATGA
CTTAANGA	CTTAATGA
CTTAANTG	CTTAATGA
CTGTACCG	CTTACCGG
CTTCTCCA	CTCTCCAT
CTTACACG	CTTACCGG
CTGGGTAG	CGGGTAGG
CTGTACGT	CTGTAGTC
CTGTACTC	CTGTAGTC
CTTACAGG	CTTACCGG
CTTACATG	CTTAATGA
CGCCTTCG	CACCTTCG
CTGTAGAC	CTGTAGTC
CTCNTCCA	CTCTCCAT
CTGTAGAT	CTGTAGTC
CTGTAGCA	CTGTAGTC
CTTACCAG	CTTACCGG
CTGTAGCC	CTGTAGTC
CTGTAGCG	CTGTAGTC
CTGTAGCT	CTGTAGTC
CTGTAGCN	CTGTAGTC
CTTACCCG	CTTACCGG
CTGTAGGC	CTGTAGTC
CTGTAGGT	CTGTAGTC
CTTACCGA	CTTACCGG
CTTACCGC	CTTACCGG
CTGTAGTA	CTGTAGTC
CTTACCGG	CTTACCGG
CTGTAGTC	CTGTAGTC
CTTACCGT	CTTACCGG
CTGTAGTG	CTGTAGTC
CTTACCGN	CTTACCGG
CTGTAGTT	CTGTAGTC
CTGTAGTN	CTGTAGTC
CTTACCTG	CTTACCGG
CTGTAGNC	CTGTAGTC
CTGTAGNT	CTGTAGTC
CTTACCNG	CTTACCGG
CTGTATCA	CTGTAGTC
CTTACGCG	CTTACCGG
CTGTATCC	CTGTAGTC
CTGTATCG	CTGTAGTC
CTGTATCT	CTGTAGTC
CTTACGGA	CTTACCGG
CTGTATCN	CTGTAGTC
CTTACGGC	CTTACCGG
CTTACGGG	CTTACCGG
CTTACGGT	CTTACCGG
CTTACGGN	CTTACCGG
CTGTATGT	CTGTAGTC
CTTCTTTA	CTCTTTAA
CTGTATTC	CTGTAGTC
CTGGTACA	CCTGGTAC
CTGGTACC	CCTGGTAC
CTGGTACG	CCTGGTAC
CTGGTACT	CCTGGTAC
CTGGTACN	CCTGGTAC
CTGGTAGG	CGGGTAGG
CTGGTAGT	CTGTAGTC
CTTACTCG	CTTACCGG
CTTACTGA	CTTAATGA
CTCNTTAA	CTCTTTAA
CTTACTGG	CTTACCGG
CTGTANGT	CTGTAGTC
CTGTANTC	CTGTAGTC
CGTTGAAA	CCGTTGAA
CTTACNCG	CTTACCGG
CGTTGAAC	CCGTTGAA
CGTTGAAG	CCGTTGAA
CGTTGAAT	CCGTTGAA
CGTTGAAN	CCGTTGAA
CTCNTTTA	CTCTTTAA
CTTACNGG	CTTACCGG
CTGTCAGT	CTGTAGTC
CTGTCCAT	CTCTCCAT
CTGTCCGA	TTGTCCGA
CTTAGATG	CTTAATGA
CTCNCCAT	CTCTCCAT
CTTAGCCG	CTTACCGG
CTTAGCGG	CTTACCGG
CTTAGGAC	TTAGGACG
CGCGAACC	CGGGAACC
CGCGAAGA	GCGCGAAG
CGCGAAGC	GCGCGAAG
CGCGAAGG	GCGCGAAG
CGCGAAGT	GCGCGAAG
CGCGAAGN	GCGCGAAG
CTGTCGTC	CTGTAGTC
CTTAGTCA	CTGTAGTC
CTTAGTCC	CTGTAGTC
CTTAGTCG	CTGTAGTC
CTTAGTCT	CTGTAGTC
CTTAGTCN	CTGTAGTC
CTTAGTGA	CTTAATGA
CGCGACGG	CCGACGGA
CTTGAATG	CTTAATGA
CTTGACAG	TTGACAGC
CTTGACCG	CTTACCGG
CTTATATC	ATTATATC
CTTATATG	CTTAATGA
CTTATCAC	TTATCACT
CTTATCCG	CTTACCGG
CTTATCGG	CTTACCGG
CTGTGAGT	CTGTAGTC
CTTATGAA	CTTAATGA
CTTATGAC	CTTAATGA
CTTATGAG	CTTAATGA
CTTATGAT	CTTAATGA
CTTATGAN	CTTAATGA
CTTATGCA	CTATGCAA
CTTGATGA	CTTAATGA
CTTATTGA	CTTAATGA
CTGTGCAA	CTATGCAA
CGCGCCCT	CCGCCCTA
CGCGCCGG	GCGCCGGG
CTTGCAAA	CTATGCAA
CTTGCAAC	CTATGCAA
CTTGCAAG	CTATGCAA
CGCGCGAA	GCGCGAAG
CTTGCAAT	CTATGCAA
CTTGCAAN	CTATGCAA
CTCAAAGA	CCAAAGAG
CTCAAATG	GTCAAATG
CTGTGGGG	TGTGGGGT
CTGTGGTC	CTGTAGTC
CTCAACAA	TCAACAAC
CTTGCCGG	CTTACCGG
CTTANATG	CTTAATGA
CTGTGTCA	CTGTAGTC
CTGTGTCC	CTGTAGTC
CTGTGTCG	CTGTAGTC
CTGTGTCT	CTGTAGTC
CTGTGTCN	CTGTAGTC
CTTANCCG	CTTACCGG
CTTANCGG	CTTACCGG
CTTGCGTT	TTGCGTTC
CGTTTAAA	GTTTAAAG
CTCAATGA	CTTAATGA
CTCAATTT	CCCAATTT
CTTANTGA	CTTAATGA
CTGTTAGT	CTGTAGTC
CTGAAGTC	CTGTAGTC
CGTTTGAC	GTTTGACT
CTGTTGAA	CCGTTGAA
CTGAATGA	CTTAATGA
CGTTTTGC	TGTTTTGC
CTCACCAT	CTCTCCAT
CTCACCGG	CTTACCGG
CTCACCGT	CCCACCGT
CTGTTGTC	CTGTAGTC
CTGTTTAA	CTCTTTAA
CTTGGTAC	CCTGGTAC
CTGTTTTG	TGTTTTGC
CTGACAGC	TTGACAGC
CTGACCGG	CTTACCGG
CTGACGGA	CCGACGGA
CTGTNAGT	CTGTAGTC
CTCAGGCT	GTCAGGCT
CNAGGTCC	CAAGGTCC
CTGTNGTC	CTGTAGTC
CTCATCCA	CTCTCCAT
CTGAGGCA	TGAGGCAT
CTCATGCA	CTATGCAA
CTGAGTCA	CTGTAGTC
CTGAGTCC	CTGTAGTC
CTGAGTCG	CTGTAGTC
CTGAGTCT	CTGTAGTC
CTGAGTCN	CTGTAGTC
CTCATTAA	CTCTTTAA
CTGAGTTT	CGAGTTTA
CTCATTGT	CCATTGTC
CTCATTTA	CTCTTTAA
CTNCTCCA	CTCTCCAT
CNAGTTTA	CGAGTTTA
CTGATAAT	CAGATAAT
CTNCTTTA	CTCTTTAA
CTGATAGT	CTGTAGTC
CTGNAGTC	CTGTAGTC
CTGATGCA	CTATGCAA
CNAAAGAG	CCAAAGAG
CTCCAAAA	TTCCAAAA
CNAAATTG	CAAATTGG
CTCCAATT	CCCAATTT
CTCCACCG	CCCACCGT
CTCCAGAG	CACCAGAG
CTCCCATA	CTCTCCAT
CTCCCATC	CTCTCCAT
CTCCCATG	CTCTCCAT
CTCCCATT	CTCTCCAT
CTCCCATN	CTCTCCAT
CTCCCCAT	CTCTCCAT
CTCCCGGC	TCCCGGCT
CTGCAGTC	CTGTAGTC
CNAAGGTC	CAAGGTCC
CTTGTAGT	CTGTAGTC
CNATGCAA	CTATGCAA
CTTGTCCG	TTGTCCGA
CTTGTGGA	TTTGTGGA
CNCAAAGA	CCAAAGAG
CNCTTTAA	CTCTTTAA
CNAATTGG	CAAATTGG
CTCCGCCA	ATCCGCCA
CTNGTAGT	CTGTAGTC
CNCAATTT	CCCAATTT
CNATTGTC	CCATTGTC
CNGGAACC	CGGGAACC
CTCCTAGC	TCCTAGCG
CTTTAAAG	GTTTAAAG
CTCCTCCA	CTCTCCAT
CNCACCGT	CCCACCGT
CTTTAATG	CTTAATGA
CTCCTCTC	TCCTCTCT
CTTTACCG	CTTACCGG
CTCCTTAA	CTCTTTAA
CTCCTTCG	CACCTTCG
CTCCTTTA	CTCTTTAA
CTTTAGTC	CTGTAGTC
CTTTATGA	CTTAATGA
CNTAATGA	CTTAATGA
CNTCTCCA	CTCTCCAT
CTTTCCAT	CTCTCCAT
CTTTCCGG	CTTACCGG
CNTACCGG	CTTACCGG
CTNTAATG	CTTAATGA
CNTCTTTA	CTCTTTAA
CTNTACCG	CTTACCGG
CNACCAGA	CACCAGAG
CNGGGAAC	CGGGAACC
CTNTAGTC	CTGTAGTC
CTCGACGG	CCGACGGA
CTTTGACT	GTTTGACT
CTCGACTT	ATCGACTT
CNGGGCGT	CCGGGCGT
CTTTGCAA	CTATGCAA
CTCGAGTC	TCGAGTCC
CNACCTTC	CACCTTCG
CNGGGTAG	CGGGTAGG
CTNTCCAT	CTCTCCAT
CTTTGTGG	TTTGTGGA
CTCGCCAT	CTCTCCAT
CTCGCCCT	CCGCCCTA
CTTTTAAA	CTCTTTAA
CTTTTAAC	CTCTTTAA
CTTTTAAG	CTCTTTAA
CTTTTAAT	CTCTTTAA
CTTTTAAN	CTCTTTAA
CNGGTAGG	CGGGTAGG
CNTATGCA	CTATGCAA
CTNTGCAA	CTATGCAA
CTTTTTAA	CTCTTTAA
CTCGGAAA	ATCGGAAA
CNACTAGT	CACTAGTT
CTCGGGCG	CCGGGCGT
CTCGTAGT	CTGTAGTC
CTNTTTAA	CTCTTTAA
CTCGTCCA	CTCTCCAT
CTCGTCTG	TCGTCTGG
CTTNAATG	CTTAATGA
CTTNACCG	CTTACCGG
CTCGTTAA	CTCTTTAA
CNTGGTAC	CCTGGTAC
CTCGTTGA	CCGTTGAA
CTCGTTTA	CTCTTTAA
CTTNATGA	CTTAATGA
CNGTAGTC	CTGTAGTC
CNTGTAGT	CTGTAGTC
CNGACGGA	CCGACGGA
CTTNCCGG	CTTACCGG
CNAGATAA	CAGATAAT
CNCATTGT	CCATTGTC
CNTTAATG	CTTAATGA
CNTTACCG	CTTACCGG
CNGAGTTT	CGAGTTTA
GAAGNGGT	GAAGGGTA
GAAGNGTA	GAAGGGTA
CNGATAAT	CAGATAAT
GAATAATT	GAAAATTT
CNCCAATT	CCCAATTT
GAANGGGT	GAAGGGTA
GAANGGTA	GAAGGGTA
GAATACGT	GAATTCGT
CNCCACCG	CCCACCGT
GAATAGAA	GATAGAAA
GAATAGCT	AATAGCTT
CNCCAGAG	CACCAGAG
CNGTTGAA	CCGTTGAA
GAATATCG	GAATTCGT
GAAAAATT	GAAAATTT
GAATATTT	GAAAATTT
GAAAACAT	AAAACATG
GAAAACTT	GAAAATTT
GAANTCGT	GAATTCGT
GAAAAGTT	GAAAATTT
GAATCCAT	GCATCCAT
GAAAATAT	GAAAATTT
GAATCCGT	GAATTCGT
GAAAATCC	AAAATCCC
GAAAATCT	GAAAATTT
GAAAATGT	GAAAATTT
GAAAATTA	GAAAATTT
GAAAATTC	GAAAATTT
GAAAATTG	GAAAATTT
GAANTTCG	GAATTCGT
GAAAATTT	GAAAATTT
GAAAATTN	GAAAATTT
GAAAATNT	GAAAATTT
GAATCGGT	GAGTCGGT
GAATCGTA	GAATTCGT
GAATCGTC	GAATTCGT
GAATCGTG	GAATTCGT
GAATCGTT	GAATTCGT
GAATCGTN	GAATTCGT
GAAAANTT	GAAAATTT
GAATCTCG	GAATTCGT
GAAACATG	AAAACATG
GAAACATT	GAAAATTT
GAATGACC	AATGACCG
CTNAATGA	CTTAATGA
GAAACGTT	AAACGTTC
GAATGCGT	GAATTCGT
GAAACTAA	AAACTAAC
GAAACTTT	GAAAATTT
GAATGGGT	GAAGGGTA
GAATGGTA	GAAGGGTA
CTNACCGG	CTTACCGG
GAATGTAG	AAATGTAG
GAATGTCG	GAATTCGT
GAAAGAAA	GATAGAAA
GACAAATG	GTCAAATG
GACAAATT	GAAAATTT
CNGCCCTA	CCGCCCTA
GAAAGATT	GAAAATTT
GAATTACA	TAATTACA
GAATTACG	GAATTCGT
GAATTAGT	GAATTCGT
GAATTATA	GACATTAT
GAATTATC	GACATTAT
GAATTATG	GACATTAT
GAATTATT	GACATTAT
GAATTATN	GACATTAT
GAATTCAG	GAATTCGT
GAAAGGGT	GAAGGGTA
GAATTCAT	GAATTCGT
GACAATAT	GACATTAT
GAAAGGTA	GAAGGGTA
GAATTCCC	GATTTCCC
GAATTCCG	GAATTCGT
GAATTCCT	GAATTCGT
GAATTCGA	GAATTCGT
GAATTCGC	GAATTCGT
GAATTCGG	GAATTCGT
GAATTCGT	GAATTCGT
GAATTCGN	GAATTCGT
GACAATTA	GACATTAT
GAATTCTA	GAATTCGT
GAATTCTC	GAATTCGT
GAATTCTG	GAATTCGT
GACAATTT	GAAAATTT
GAATTCTT	GAATTCGT
GAATTCTN	GAATTCGT
GAATTCNG	GAATTCGT
GAATTCNT	GAATTCGT
GAAAGTTT	GAAAATTT
GAATTGCG	GAATTCGT
GAATTGGT	GAATTCGT
GAATTGTA	GAATTCGT
GAATTGTC	GAATTCGT
GAATTGTG	GAATTCGT
GAATTGTT	GAATTCGT
GAATTGTN	GAATTCGT
GAATTTCC	GATTTCCC
GAATTTCG	GAATTCGT
GAATTTGT	GAATTCGT
CNCCTTCG	CACCTTCG
GAATTNCG	GAATTCGT
GACACCGT	GACCCGTC
GAAATATT	GAAAATTT
GAATTNGT	GAATTCGT
GAAATCCC	AAAATCCC
GAAATCGT	GAATTCGT
GACACGTC	GACCCGTC
GACACTAT	GACATTAT
GACACTTA	GACATTAT
GAATNCGT	GAATTCGT
GAAATGTA	AAATGTAG
GAAATTAT	GACATTAT
GAAATTCG	GAATTCGT
CTNATGCA	CTATGCAA
GAAATTGG	CAAATTGG
GAAATTTA	GAAAATTT
GACAGAAA	GATAGAAA
GAAATTTC	GAAAATTT
GAAATTTG	GAAAATTT
GAAATTTT	GAAAATTT
GAAATTTN	GAAAATTT
GAATNTCG	GAATTCGT
GACAGGAC	ACAGGACT
GACAGGCT	GTCAGGCT
GAAANATT	GAAAATTT
GACAGGGT	GAAGGGTA
GAANAATT	GAAAATTT
GACAGTAT	GACATTAT
CNCGACGG	CCGACGGA
GACAGTTA	GACATTAT
GACATAAT	GACATTAT
GACATATA	GACATTAT
GACATATC	GACATTAT
GAAANTTT	GAAAATTT
GACATATG	GACATTAT
GACATATT	GACATTAT
GACATATN	GACATTAT
GAANATTT	GAAAATTT
GACATCAT	GACATTAT
GACATCCA	GCATCCAT
GACATCTA	GACATTAT
GACATGAT	GACATTAT
GACATGTA	GACATTAT
CNCGCCCT	CCGCCCTA
GAACAATT	GAAAATTT
GACATTAA	GACATTAT
GACATTAC	GACATTAT
GACATTAG	GACATTAT
GACATTAT	GACATTAT
GACATTAN	GACATTAT
GACATTCA	GACATTAT
GACATTCG	GAATTCGT
GACATTCT	GACATTAT
GACATTGA	GACATTAT
GACATTGT	GACATTAT
GACNCCGT	GACCCGTC
GACATTTA	GACATTAT
GACATTTC	GACATTAT
GACATTTG	GACATTAT
GACATTTT	GACATTAT
GACATTTN	GACATTAT
GACATTNA	GACATTAT
GACATTNT	GACATTAT
GACATNAT	GACATTAT
GACATNTA	GACATTAT
GACNCGTC	GACCCGTC
GAACATTA	GACATTAT
GAACATTT	GAAAATTT
GATATAAA	GATAGAAA
GACANTAT	GACATTAT
CNCGGGCG	CCGGGCGT
GATATCCC	GATTTCCC
GACANTTA	GACATTAT
GATATGAA	GATAGAAA
GATATTAT	GACATTAT
GATATTCC	GATTTCCC
GATATTCG	GAATTCGT
GAGGGGTA	GAAGGGTA
GAGGGTAA	GAAGGGTA
GAGGGTAC	GAAGGGTA
GAGGGTAG	GAAGGGTA
GAGGGTAT	GAAGGGTA
GAGGGTAN	GAAGGGTA
GATANAAA	GATAGAAA
GATANGAA	GATAGAAA
CNCGTTGA	CCGTTGAA
GAGGTCGG	GAGTCGGT
GATGGAAA	GATAGAAA
GATGGCAC	GTGGCACC
GAGGTGGT	AGGTGGTT
GATCAAAT	GTCAAATG
GATGGGCT	ATGGGCTA
GACNTTAT	GACATTAT
GATGGGTA	GAAGGGTA
GATCAGAA	GATAGAAA
GATCAGGC	GTCAGGCT
GATCATTA	GACATTAT
CNCTAGTT	CACTAGTT
GAACCAGC	TAACCAGC
GATCCATA	GCATCCAT
GATCCATC	GCATCCAT
GATCCATG	GCATCCAT
GATCCATT	GCATCCAT
GATCCATN	GCATCCAT
GATCCCGT	GACCCGTC
GAACCCGT	GACCCGTC
GAACCCTG	AACCCTGG
GAACCGAA	GTACCGAA
GATCCGCC	ATCCGCCA
GATCCGTC	GACCCGTC
GAACCGTC	GACCCGTC
CNCTCCAT	CTCTCCAT
GAGTACGG	GAGTCGGT
GAGAAATT	GAAAATTT
GAGTAGAA	GATAGAAA
GAGTAGGT	GAGTCGGT
GATCGAAA	GATAGAAA
GATCGACT	ATCGACTT
GATCGGAA	ATCGGAAA
GAGAATTT	GAAAATTT
GAACGGGT	GAAGGGTA
GAACGGTA	GAAGGGTA
GATCGGTA	GAGTCGGT
GATCGGTC	GAGTCGGT
GATGTCCC	GATTTCCC
GATCGGTG	GAGTCGGT
GATCGGTT	GAGTCGGT
GATCGGTN	GAGTCGGT
GATGTCGG	GAGTCGGT
GAGTCAGG	GAGTCGGT
GAGTCAGT	GAGTCGGT
GAACGTTC	AAACGTTC
GAGTCCGG	GAGTCGGT
CNCTGGTA	CCTGGTAC
GAGTCCGT	GAGTCGGT
GATGTTCC	GATTTCCC
GAGTCGAG	GAGTCGGT
GAGTCGAT	GAGTCGGT
GAACTAAC	AAACTAAC
GAGTCGCG	GAGTCGGT
GAGTCGCT	GAGTCGGT
GAGTCGGA	GAGTCGGT
GAGTCGGC	GAGTCGGT
GAGTCGGG	GAGTCGGT
GAGTCGGT	GAGTCGGT
GAGTCGGN	GAGTCGGT
GAGTCGTA	GAGTCGGT
GAGTCGTC	GAGTCGGT
GAGTCGTG	GAGTCGGT
GAGTCGTT	GAGTCGGT
GAGTCGTN	GAGTCGGT
GAGTCGNG	GAGTCGGT
GAGTCGNT	GAGTCGGT
GAGACGGT	GAGTCGGT
GAGTCTCA	AGTCTCAG
GATCTCCC	GATTTCCC
GAACTCGT	GAATTCGT
GAGTCTGG	GAGTCGGT
GAGTCTGT	GAGTCGGT
GAGTCNGG	GAGTCGGT
GAGTCNGT	GAGTCGGT
GATCTTCC	GATTTCCC
GAACTTCG	GAATTCGT
GAGAGAAA	GATAGAAA
GAGTGCGG	GAGTCGGT
GAGAGGCC	AGAGGCCG
GAGAGGGT	GAAGGGTA
GATTAAAG	GTTTAAAG
GAGTGGGT	GAGTCGGT
GAGTGGTA	GAGTCGGT
GAGTGGTC	GAGTCGGT
GAGTGGTG	GAGTCGGT
GAGTGGTT	GAGTCGGT
GAGTGGTN	GAGTCGGT
GATTACCC	GATTTCCC
GAGTGTTA	GCGTGTTA
GACCACGT	GACCCGTC
GATTAGAA	GATAGAAA
GACCAGAG	CACCAGAG
GAGATAAT	CAGATAAT
GATTATAT	ATTATATC
GACCAGTC	GACCCGTC
GATTATCC	GATTTCCC
GACCATTA	GACATTAT
GAAGAAAA	GATAGAAA
GAGATCGG	GAGTCGGT
GAAGAAAC	GATAGAAA
GAAGAAAG	GATAGAAA
GATGAAAA	GATAGAAA
GAAGAAAT	GATAGAAA
GATGAAAC	GATAGAAA
GAAGAAAN	GATAGAAA
GATGAAAG	GATAGAAA
GATGAAAT	GATAGAAA
GATGAAAN	GATAGAAA
GAGTTCCC	GATTTCCC
GAGTTCGG	GAGTCGGT
GAGTTCGT	GAATTCGT
GATTCAAC	ATTCAACC
GAAGAATT	GAAAATTT
GATGACCG	AATGACCG
GAGTTGCG	AAGTTGCG
GAGATTAT	GACATTAT
GAGTTGGT	GAGTCGGT
GAGATTCG	GAATTCGT
GATTCCCA	GATTTCCC
GATTCCCC	GATTTCCC
GACCCAGT	GACCCGTC
GATTCCCG	GATTTCCC
GACCCATC	GACCCGTC
GATTCCCT	GATTTCCC
GATTCCCN	GATTTCCC
GATGAGAA	GATAGAAA
GAGTTTAA	CGAGTTTA
GAGTTTAC	CGAGTTTA
GATTCCTG	ATTCCTGA
GAGTTTAG	CGAGTTTA
GAGTTTAT	CGAGTTTA
GAGTTTAN	CGAGTTTA
GAGTTTCC	GATTTCCC
GAAGAGGT	GAAGGGTA
GAAGAGTA	GAAGGGTA
GACCCCGT	GACCCGTC
GACCCCTC	GACCCGTC
GATTCGGT	GAGTCGGT
GATTCGTA	GAATTCGT
GATTCGTC	GAATTCGT
GATTCGTG	GAATTCGT
GATTCGTT	GAATTCGT
GAAGATCG	TAAGATCG
GATTCGTN	GAATTCGT
GACCCGAA	ACCCGAAC
GACCCGAC	GACCCGTC
GACCCGAT	GACCCGTC
GACCCGCA	GACCCGTC
GACCCGCC	GACCCGTC
GACCCGCG	GACCCGTC
GACCCGCT	GACCCGTC
GACCCGCN	GACCCGTC
GAAGATTT	GAAAATTT
GACCCGGC	GACCCGTC
GATTCTCC	GATTTCCC
GACCCGGT	GACCCGTC
GACCCGTA	GACCCGTC
GACCCGTC	GACCCGTC
GACCCGTG	GACCCGTC
GACCCGTT	GACCCGTC
GACCCGTN	GACCCGTC
GACCCGNC	GACCCGTC
GACCCGNT	GACCCGTC
GACCCTCA	GACCCGTC
GACCCTCC	GACCCGTC
GACCCTCG	GACCCGTC
GACCCTCT	GACCCGTC
GACCCTCN	GACCCGTC
GACCCTGG	AACCCTGG
GACCCTGT	GACCCGTC
GACCCTTC	GACCCGTC
GATTGAAA	GATAGAAA
GAGCAAAG	AGCAAAGG
GATTGACT	GTTTGACT
GACCCNGT	GACCCGTC
GACCCNTC	GACCCGTC
GAGTNCGG	GAGTCGGT
GCATGCAT	GCATCCAT
GCATGCCA	GCATCCAT
GACCGAAA	GTACCGAA
GACCGAAC	GTACCGAA
GACCGAAG	GTACCGAA
GATTGCCC	GATTTCCC
GACCGAAT	GTACCGAA
GACCGAAN	GTACCGAA
GAGTNGGT	GAGTCGGT
GAAGCGGT	GAAGGGTA
GATTGGCG	TATTGGCG
GAAGCGTA	GAAGGGTA
GACCGCGT	GACCCGTC
GATTGTCC	GATTTCCC
GCATGTTA	GCGTGTTA
GAGCATTA	GACATTAT
GACCGGTC	GACCCGTC
GACCGTCA	GACCCGTC
GACCGTCC	GACCCGTC
GACCGTCG	GACCCGTC
GACCGTCT	GACCCGTC
GACCGTCN	GACCCGTC
GCAACAAC	TCAACAAC
GATTTAAA	GTTTAAAG
GATTTACC	GATTTCCC
GAAGGAGT	GAAGGGTA
GAAGGATA	GAAGGGTA
GCATTATA	GACATTAT
GCATTATC	GACATTAT
GCATTATG	GACATTAT
GCATTATT	GACATTAT
GCATTATN	GACATTAT
GCATTCAT	GCATCCAT
GATTTCAC	GATTTCCC
GCATTCCA	GCATCCAT
GATTTCCA	GATTTCCC
GATTTCCC	GATTTCCC
GATTTCCG	GATTTCCC
GATTTCCT	GATTTCCC
GCAACCAT	GCATCCAT
GATTTCCN	GATTTCCC
GATTTCGC	GATTTCCC
GAAGGCGT	GAAGGGTA
GATTTCGT	GAATTCGT
GCATTCGT	GAATTCGT
GAAGGCTA	GAAGGGTA
GATTTCTC	GATTTCCC
GACCTAAT	GCCTAATA
GATTTCNC	GATTTCCC
GAAGGGAA	GAAGGGTA
GAAGGGAC	GAAGGGTA
GAAGGGAG	GAAGGGTA
GATTTGAC	GTTTGACT
GAAGGGAT	GAAGGGTA
GAAGGGAN	GAAGGGTA
GAAGGGCA	GAAGGGTA
GAGCCCGT	GACCCGTC
GATTTGCC	GATTTCCC
GAAGGGCT	GAAGGGTA
GAAGGGGA	GAAGGGTA
GAAGGGGT	GAAGGGTA
GAAGGGTA	GAAGGGTA
GAAGGGTC	GAAGGGTA
GAAGGGTG	GAAGGGTA
GCATTGTC	CCATTGTC
GAAGGGTT	GAAGGGTA
GAAGGGTN	GAAGGGTA
GAAGGGNA	GAAGGGTA
GAAGGGNT	GAAGGGTA
GAAGGTAA	GAAGGGTA
GACCTCGT	GACCCGTC
GAAGGTAC	GAAGGGTA
GATTTTCC	GATTTCCC
GAAGGTAG	GAAGGGTA
GAAGGTAT	GAAGGGTA
GAGCCGGG	GCGCCGGG
GAAGGTAN	GAAGGGTA
GCATTTCC	GATTTCCC
GAGCCGGT	GAGTCGGT
GAAGGTCC	CAAGGTCC
GAGCCGTC	GACCCGTC
GAAGGTGT	GAAGGGTA
GAAGGTTA	GAAGGGTA
GATTTNCC	GATTTCCC
GACCTGTC	GACCCGTC
GAAGGNGT	GAAGGGTA
GACCTTAT	GACATTAT
GAAGGNTA	GAAGGGTA
GACCTTCG	CACCTTCG
GCCAAAGA	CCAAAGAG
GCCAAATA	GCCTAATA
GCCAAATG	GTCAAATG
GANGGGTA	GAAGGGTA
GAGCGAAG	GCGCGAAG
GCATNCAT	GCATCCAT
GCATNCCA	GCATCCAT
GAAGTCGG	GAGTCGGT
GAAGTCGT	GAATTCGT
GAAGTGGT	GAAGGGTA
GCAAGCTC	GCTAGCTC
GAAGTGTA	GAAGGGTA
GCCAATAA	GCCTAATA
GCCAATAC	GCCTAATA
GCCAATAG	GCCTAATA
GCCAATAT	GCCTAATA
GCCAATAN	GCCTAATA
GACCNCGT	GACCCGTC
GAAGTTCG	GAATTCGT
GAAGTTGC	AAGTTGCG
GCCAATTT	CCCAATTT
GAGCGGTA	GAGTCGGT
GAGCGGTC	GAGTCGGT
GCAAGGGT	GAAGGGTA
GAGCGGTG	GAGTCGGT
GAGCGGTT	GAGTCGGT
GAGCGGTN	GAGTCGGT
GCAAGGTC	CAAGGTCC
GACCNGTC	GACCCGTC
GANGTCGG	GAGTCGGT
GCCACCGT	CCCACCGT
GCAATCCA	GCATCCAT
GAGCTCGG	GAGTCGGT
GACGATAC	ACGATACG
GAGCTTCT	AGCTTCTT
GCAATTCG	GAATTCGT
GACGATTA	GACATTAT
GCANCCAT	GCATCCAT
GAGNCGGT	GAGTCGGT
GCCAGCTC	GCTAGCTC
GACGCCCA	TACGCCCA
GACGCCGG	GCGCCGGG
GACGCCGT	GACCCGTC
GCCAGGCT	GTCAGGCT
GACGCGAA	GCGCGAAG
GACGCGTC	GACCCGTC
GANTAGAA	GATAGAAA
GCCATAAT	GCCTAATA
GCCATCCA	GCATCCAT
GACGGGTA	GAAGGGTA
GACGGTAT	TACGGTAT
GANTCGGT	GAGTCGGT
GCACATTA	GACATTAT
GAGNTCGG	GAGTCGGT
GCANTCCA	GCATCCAT
GAGGCACC	GTGGCACC
GCCATGTA	TGCCATGT
GCCATGTC	TGCCATGT
GCCATGTG	TGCCATGT
GCCATGTT	TGCCATGT
GCCATGTN	TGCCATGT
GAGGCATA	TGAGGCAT
GAGGCATC	TGAGGCAT
GAGGCATG	TGAGGCAT
GAGGCATT	TGAGGCAT
GAGGCATN	TGAGGCAT
GCCATTAT	GACATTAT
GATTNCCC	GATTTCCC
GAGGCCGA	AGAGGCCG
GCCATTGT	CCATTGTC
GAGGCCGC	AGAGGCCG
GAGGCCGG	AGAGGCCG
GAGGCCGT	AGAGGCCG
GCACCAGA	CACCAGAG
GAGGCCGN	AGAGGCCG
GCACCATA	GCATCCAT
GCACCATC	GCATCCAT
GCACCATG	GCATCCAT
GCACCATT	GCATCCAT
GCACCATN	GCATCCAT
GCACCCAT	GCATCCAT
GAGGCGGT	GAGTCGGT
GCACCCGT	GACCCGTC
GATTNTCC	GATTTCCC
GCACCGAA	GTACCGAA
GAGGCTTA	AGGCTTAA
GCACCGGG	GCGCCGGG
GCACCTTC	CACCTTCG
GANTTCCC	GATTTCCC
GANTTCGT	GAATTCGT
GCACGAAG	GCGCGAAG
GATNAGAA	GATAGAAA
GATAAAAA	GATAGAAA
GATAAAAC	GATAGAAA
GATAAAAG	GATAGAAA
GATAAAAT	GATAGAAA
GANTTTCC	GATTTCCC
GATAAAAN	GATAGAAA
GATAAATT	GAAAATTT
GCTCCATA	GCATCCAT
GCTCCATC	GCATCCAT
GCTCCATG	GCATCCAT
GCTCCATT	GCATCCAT
GCTCCATN	GCATCCAT
GATAAGAA	GATAGAAA
GCCCAATA	GCCTAATA
GCCCAATT	CCCAATTT
GATAAGGG	TATAAGGG
GCTCCGGG	GCGCCGGG
GCCCACCG	CCCACCGT
GATAATTT	GAAAATTT
GCACTAAT	GCCTAATA
GCACTAGT	CACTAGTT
GATACAAA	GATAGAAA
GCACTCCA	GCATCCAT
GCTCGAAG	GCGCGAAG
GACGTCGG	GAGTCGGT
GATACCGA	GTACCGAA
GATACGAA	GATAGAAA
GATNGAAA	GATAGAAA
GCTCGCTC	GCTAGCTC
GACGTGTT	GCGTGTTA
GACGTTAT	GACATTAT
GCGACCGG	GCGCCGGG
GATAGAAA	GATAGAAA
GATAGAAC	GATAGAAA
GATAGAAG	GATAGAAA
GATAGAAT	GATAGAAA
GATAGAAN	GATAGAAA
GATAGACA	GATAGAAA
GCGTAATA	GCCTAATA
GCGACGAA	GCGCGAAG
GATAGAGA	GATAGAAA
GCTCTAAT	GCCTAATA
GATAGATA	GATAGAAA
GCCCCGGG	GCGCCGGG
GCGACGGA	CCGACGGA
GATAGANA	GATAGAAA
GCGACGGG	GCGCCGGG
GATAGCAA	GATAGAAA
GCCCCGTC	GACCCGTC
GCTCTCCA	CTCTCCAT
GATAGCTC	GCTAGCTC
GATAGCTT	AATAGCTT
GATAGGAA	GATAGAAA
GCGTAGCT	GCTAGCTC
GATAGGGT	GAAGGGTA
GCGTAGTT	GCGTGTTA
GATAGTAA	GATAGAAA
GATNTCCC	GATTTCCC
GCGAGAAG	GCGCGAAG
GCGTATTA	GCGTGTTA
GCCCGAAC	ACCCGAAC
GCCCGAAG	GCGCGAAG
GCTCTTTA	CTCTTTAA
GATAGNAA	GATAGAAA
GCGAGCTC	GCTAGCTC
GATNTTCC	GATTTCCC
GACTAAGC	ACTAAGCG
GACTAATA	GCCTAATA
GCGAGTCC	TCGAGTCC
GCGTCCAT	GCATCCAT
GCCCGGCT	TCCCGGCT
GCCCGGGA	GCGCCGGG
GCCCGGGC	GCGCCGGG
GCGAGTTA	GCGTGTTA
GCCCGGGG	GCGCCGGG
GCCCGGGT	GCGCCGGG
GCGTCCGG	GCGCCGGG
GCGAGTTT	CGAGTTTA
GCCCGGGN	GCGCCGGG
GCGTCGAA	GCGCGAAG
GCCCGTCA	GACCCGTC
GCCCGTCC	GACCCGTC
GCCCGTCG	GACCCGTC
GCCCGTCT	GACCCGTC
GCCCGTCN	GACCCGTC
GACTAGAA	GATAGAAA
GCGTCGGG	GCGCCGGG
GCGTCGGT	GAGTCGGT
GCGTCGTT	GCGTGTTA
GACTAGCT	GCTAGCTC
GCGATACG	ACGATACG
GACTAGTT	CACTAGTT
GCGTCTGG	TCGTCTGG
GCGTCTTA	GCGTGTTA
GCGATCCA	GCATCCAT
GACTATTA	GACATTAT
GCGTGAAG	GCGCGAAG
GCGATGTT	GCGTGTTA
GCGTGATA	GCGTGTTA
GCGTGATT	GCGTGTTA
GCTGAGCT	GCTAGCTC
GCGTGCTA	GCGTGTTA
GCGTGCTT	GCGTGTTA
GANAAATT	GAAAATTT
GCAGATAA	CAGATAAT
GACTCCGT	GACCCGTC
GCGTGGTA	GCGTGTTA
GCGTGGTT	GCGTGTTA
GACTCGGT	GAGTCGGT
GCGTGTAA	GCGTGTTA
GCGTGTAC	GCGTGTTA
GACTCGTC	GACCCGTC
GCGTGTAG	GCGTGTTA
GCGTGTAT	GCGTGTTA
GCGTGTAN	GCGTGTTA
GCGTGTCA	GCGTGTTA
GCGTGTCT	GCGTGTTA
GCGTGTGA	GCGTGTTA
GCGTGTGT	GCGTGTTA
GCGTGTTA	GCGTGTTA
GCGTGTTC	GCGTGTTA
GCGTGTTG	GCGTGTTA
GCGTGTTT	GCGTGTTA
GCGTGTTN	GCGTGTTA
GCGTGTNA	GCGTGTTA
GCGTGTNT	GCGTGTTA
GANAATTT	GAAAATTT
GCGTGNTA	GCGTGTTA
GCAGCCAT	GCATCCAT
GCGTGNTT	GCGTGTTA
GCTTAAAG	GTTTAAAG
GCAGCCGG	GCGCCGGG
GCTGCCGG	GCGCCGGG
GCAGCGAA	GCGCGAAG
GCTTAATA	GCCTAATA
GCTTAATG	CTTAATGA
GCTGCGAA	GCGCGAAG
GCTTACCG	CTTACCGG
GCAGCTCA	GCTAGCTC
GCAGCTCC	GCTAGCTC
GCGCAAAG	GCGCGAAG
GCAGCTCG	GCTAGCTC
GCAGCTCT	GCTAGCTC
GCAGCTCN	GCTAGCTC
GCTGCTCA	GCTAGCTC
GCTGCTCC	GCTAGCTC
GCTGCTCG	GCTAGCTC
GCTGCTCT	GCTAGCTC
GCGCAAGA	GCGCGAAG
GCTGCTCN	GCTAGCTC
GCGCAAGC	GCGCGAAG
GCGCAAGG	GCGCGAAG
GCGCAAGT	GCGCGAAG
GCGCAAGN	GCGCGAAG
GCGTTGAA	CCGTTGAA
GCTTAGCT	GCTAGCTC
GCGTTGTT	GCGTGTTA
GCGCACGG	GCGCCGGG
GCGTTTAA	GCGTGTTA
GCGTTTAC	GCGTGTTA
GCGTTTAG	GCGTGTTA
GCGTTTAT	GCGTGTTA
GCGTTTAN	GCGTGTTA
GCGCAGAA	GCGCGAAG
GCAGGACT	ACAGGACT
GCGTTTTA	GCGTGTTA
GCGCAGGG	GCGCCGGG
GCTGGCAC	GTGGCACC
GCAGGCTA	GTCAGGCT
GCAGGCTC	GTCAGGCT
GCAGGCTG	GTCAGGCT
GCAGGCTT	GTCAGGCT
GCAGGCTN	GTCAGGCT
GCTGGCTC	GCTAGCTC
GCCCTAAT	GCCTAATA
GCAAAATT	GAAAATTT
GCAGGGTA	GAAGGGTA
GCGCCAAG	GCGCGAAG
GCTGGTAC	CCTGGTAC
GACTTATA	GACATTAT
GACTTATC	GACATTAT
GACTTATG	GACATTAT
GACTTATT	GACATTAT
GACTTATN	GACATTAT
GCGCCAGG	GCGCCGGG
GACTTCCC	GATTTCCC
GCAAAGAG	CCAAAGAG
GCTTCCAT	GCATCCAT
GCAAAGGA	AGCAAAGG
GCAAAGGC	AGCAAAGG
GCAAAGGG	AGCAAAGG
GCAAAGGT	AGCAAAGG
GACTTCGT	GAATTCGT
GCAAAGGN	AGCAAAGG
GCGCCCGG	GCGCCGGG
GCGCCCTA	CCGCCCTA
GCGCCGAA	GCGCGAAG
GCGCCGAG	GCGCCGGG
GCGTNGTT	GCGTGTTA
GCAAATGA	GTCAAATG
GCAAATGC	GTCAAATG
GCGCCGCG	GCGCCGGG
GCAAATGG	GTCAAATG
GCAAATGT	GTCAAATG
GCAAATGN	GTCAAATG
GCGCCGGA	GCGCCGGG
GCGCCGGC	GCGCCGGG
GCGCCGGG	GCGCCGGG
GCAAATTG	CAAATTGG
GCGCCGGT	GCGCCGGG
GCAAATTT	GAAAATTT
GCGCCGGN	GCGCCGGG
GCTGTAGT	CTGTAGTC
GCGCCGTG	GCGCCGGG
GACTTTAT	GACATTAT
GCGCCGNG	GCGCCGGG
GCGTNTTA	GCGTGTTA
GCAGTCCA	GCATCCAT
GACTTTCC	GATTTCCC
GCAGTCGG	GAGTCGGT
GCGCCTGG	GCGCCGGG
GCGCGAAA	GCGCGAAG
GCTTCTTA	AGCTTCTT
GCGCGAAC	GCGCGAAG
GCTTCTTC	AGCTTCTT
GCGCGAAG	GCGCGAAG
GCTTCTTG	AGCTTCTT
GCGCGAAT	GCGCGAAG
GCTTCTTT	AGCTTCTT
GCGCGAAN	GCGCGAAG
GCTTCTTN	AGCTTCTT
GCGCGACA	GCGCGAAG
GCGCGACG	GCGCGAAG
GCGCGAGA	GCGCGAAG
GCGCGAGC	GCGCGAAG
GCGCGAGG	GCGCGAAG
GCGCGAGT	GCGCGAAG
GCGCGAGN	GCGCGAAG
GCGCGATA	GCGCGAAG
GCGCCNGG	GCGCCGGG
GCGCGATG	GCGCGAAG
GCGCGANA	GCGCGAAG
GCAGTGTT	GCGTGTTA
GCGCGANG	GCGCGAAG
GCTGTGTT	GCGTGTTA
GCGCGCAA	GCGCGAAG
GCGCGCAG	GCGCGAAG
GCTGTTAA	GCGTGTTA
GCTGTTAC	GCGTGTTA
GCTGTTAG	GCGTGTTA
GCTGTTAT	GCGTGTTA
GCTGTTAN	GCGTGTTA
GCGCGCGG	GCGCCGGG
GCGCGGAA	GCGCGAAG
GCGCGGAG	GCGCGAAG
GCTTGACT	GTTTGACT
GCGCGGGA	GCGCCGGG
GCGCGGGC	GCGCCGGG
GCGCGGGG	GCGCCGGG
GCGCGGGT	GCGCCGGG
GCGCGGGN	GCGCCGGG
GCGCGTAA	GCGCGAAG
GCGCGTAG	GCGCGAAG
GCGCGTTA	GCGTGTTA
GCNGTGTT	GCGTGTTA
GCGCGNAA	GCGCGAAG
GCGCGNAG	GCGCGAAG
GCTTGCTC	GCTAGCTC
GCGCTAAG	GCGCGAAG
GCGCTAAT	GCCTAATA
GCCGAAGA	GCGCGAAG
GCCGAAGC	GCGCGAAG
GCCGAAGG	GCGCGAAG
GCCGAAGT	GCGCGAAG
GCCGAAGN	GCGCGAAG
GCCGAATA	GCCTAATA
GCGCTCGG	GCGCCGGG
GCGCTGAA	GCGCGAAG
GCCGACGG	CCGACGGA
GCTTGTTA	GCGTGTTA
GCGCTGGG	GCGCCGGG
GCGCTGTT	GCGTGTTA
GCGNCCGG	GCGCCGGG
GCGNCGAA	GCGCGAAG
GCATAATA	GCCTAATA
GCGNCGGG	GCGCCGGG
GCATACAT	GCATCCAT
GCATACCA	GCATCCAT
GCGCNAAG	GCGCGAAG
GCATAGAA	GATAGAAA
GCTTTAAA	GTTTAAAG
GCATAGCT	GCTAGCTC
GCGCNCGG	GCGCCGGG
GCNTAATA	GCCTAATA
GCCGCCCT	CCGCCCTA
GCGCNGAA	GCGCGAAG
GCCGCCGG	GCGCCGGG
GCGNGAAG	GCGCGAAG
GCGCNGGG	GCGCCGGG
GCCGCGAA	GCGCGAAG
GCTTTCCC	GATTTCCC
GACNATTA	GACATTAT
GCNTAGCT	GCTAGCTC
GCATCAAT	GCATCCAT
GCATCACA	GCATCCAT
GCTTTGAC	GTTTGACT
GCATCATA	GCATCCAT
GCATCATC	GCATCCAT
GCATCATG	GCATCCAT
GCATCATT	GCATCCAT
GCATCATN	GCATCCAT
GCATCCAA	GCATCCAT
GCATCCAC	GCATCCAT
GCATCCAG	GCATCCAT
GANAGAAA	GATAGAAA
GCATCCAT	GCATCCAT
GCATCCAN	GCATCCAT
GCATCCCA	GCATCCAT
GCATCCCT	GCATCCAT
GCATCCGA	GCATCCAT
GCATCCGT	GCATCCAT
GCATCCTA	GCATCCAT
GCATCCTC	GCATCCAT
GCATCCTG	GCATCCAT
GCATCCTT	GCATCCAT
GCATCCTN	GCATCCAT
GCATCCNA	GCATCCAT
GCATCCNT	GCATCCAT
GCGGAAGA	GCGCGAAG
GCGGAAGC	GCGCGAAG
GCGGAAGG	GCGCGAAG
GCGGAAGT	GCGCGAAG
GCGGAAGN	GCGCGAAG
GCATCGAT	GCATCCAT
GCATCGCA	GCATCCAT
GCGNGTTA	GCGTGTTA
GCATCTAT	GCATCCAT
GCATCTCA	GCATCCAT
GCNTCCAT	GCATCCAT
GANAGGGT	GAAGGGTA
GCATCNAT	GCATCCAT
GCATCNCA	GCATCCAT
GCCGGGCG	CCGGGCGT
GCGGCACC	GTGGCACC
GCCGTAAT	GCCTAATA
GCGNTGTT	GCGTGTTA
GCGGCCGG	GCGCCGGG
GCGGCGAA	GCGCGAAG
GCGGCGGG	GCGCCGGG
GANATTAT	GACATTAT
GANATTCG	GAATTCGT
GCCGTGTT	GCGTGTTA
GCCGTTGA	CCGTTGAA
GCNTGTTA	GCGTGTTA
GCGGGAAC	CGGGAACC
GCGGGAAG	GCGCGAAG
GCTNAGCT	GCTAGCTC
GCGGGCGT	CCGGGCGT
GGACATTA	GACATTAT
GCGGGTAG	CGGGTAGG
GCGGGTTA	GCGTGTTA
GCTAAATA	TGCTAAAT
GCTAAATC	TGCTAAAT
GCTAAATG	TGCTAAAT
GCTAAATT	TGCTAAAT
GCTAAATN	TGCTAAAT
GGCAAAGG	AGCAAAGG
GGCAAATG	GTCAAATG
GCTAACTC	GCTAGCTC
GGACCCGT	GACCCGTC
GCTAAGCG	ACTAAGCG
GCTAAGCT	GCTAGCTC
GCCTAAAA	GCCTAATA
GCCTAAAC	GCCTAATA
GCCTAAAG	GCCTAATA
GCCTAAAT	GCCTAATA
GCCTAAAN	GCCTAATA
GCCTAACA	GCCTAATA
GCCTAACT	GCCTAATA
GGACCGAA	GTACCGAA
GCCTAAGA	GCCTAATA
GCCTAAGT	GCCTAATA
GCCTAATA	GCCTAATA
GCTAATAA	GCCTAATA
GCCTAATC	GCCTAATA
GCTAATAC	GCCTAATA
GCCTAATG	GCCTAATA
GCTAATAG	GCCTAATA
GCCTAATT	GCCTAATA
GCTAATAT	GCCTAATA
GCCTAATN	GCCTAATA
GCTAATAN	GCCTAATA
GCCTAANA	GCCTAATA
GCCTAANT	GCCTAATA
GCCTACAT	GCCTAATA
GCCTACTA	GCCTAATA
GCGGTGTT	GCGTGTTA
GCCTAGAT	GCCTAATA
GCCTAGCG	TCCTAGCG
GCCTAGCT	GCTAGCTC
GCGGTTAA	GCGTGTTA
GCGGTTAC	GCGTGTTA
GCGGTTAG	GCGTGTTA
GCGGTTAT	GCGTGTTA
GCGGTTAN	GCGTGTTA
GCCTAGTA	GCCTAATA
GCCTATAA	GCCTAATA
GCCTATAC	GCCTAATA
GCCTATAG	GCCTAATA
GCCTATAT	GCCTAATA
GCCTATAN	GCCTAATA
GANCATTA	GACATTAT
GCCTATTA	GCCTAATA
GCTACCGA	GTACCGAA
GCCTANAT	GCCTAATA
GGCATCCA	GCATCCAT
GCTACCTC	GCTAGCTC
GCCTANTA	GCCTAATA
GCTACGCT	GCTAGCTC
GCTACTCA	GCTAGCTC
GCTACTCC	GCTAGCTC
GCTACTCG	GCTAGCTC
GCTACTCT	GCTAGCTC
GCTACTCN	GCTAGCTC
GGCATTAT	GACATTAT
GANCCCGT	GACCCGTC
GCTNGCTC	GCTAGCTC
GCTAGAAA	GATAGAAA
GANCCGTC	GACCCGTC
GCTAGACT	GCTAGCTC
GCTAGATC	GCTAGCTC
GCTAGCAC	GCTAGCTC
GCTAGCAT	GCTAGCTC
GCTAGCCA	GCTAGCTC
GCTAGCCC	GCTAGCTC
GCTAGCCG	GCTAGCTC
GCTAGCCT	GCTAGCTC
GCTAGCCN	GCTAGCTC
GCTAGCGC	GCTAGCTC
GCTAGCGT	GCTAGCTC
GCTAGCTA	GCTAGCTC
GCTAGCTC	GCTAGCTC
GCTAGCTG	GCTAGCTC
GCTAGCTT	GCTAGCTC
GCTAGCTN	GCTAGCTC
GCTAGCNC	GCTAGCTC
GCTAGCNT	GCTAGCTC
GCTAGGCT	GCTAGCTC
GCTAGGTC	GCTAGCTC
GGGAGACT	TGGAGACT
GGCAGGCT	GTCAGGCT
GCTAGTCA	GCTAGCTC
GCTAGTCC	GCTAGCTC
GCTAGTCG	GCTAGCTC
GCTAGTCT	GCTAGCTC
GCTAGTCN	GCTAGCTC
GCTAGTTC	GCTAGCTC
GCTAGNCT	GCTAGCTC
GCTAGNTC	GCTAGCTC
GCTATCCA	GCATCCAT
GCTATCTC	GCTAGCTC
GCTATGCA	CTATGCAA
GCTATGCT	GCTAGCTC
GGCCATGT	TGCCATGT
GCTANCTC	GCTAGCTC
GCTANGCT	GCTAGCTC
GGCCCGTC	GACCCGTC
GGAGACTA	TGGAGACT
GGAGACTC	TGGAGACT
GGAGACTG	TGGAGACT
GGAGACTT	TGGAGACT
GGAGACTN	TGGAGACT
GCTCAAAT	GTCAAATG
GCTCAGCT	GCTAGCTC
GCTCAGGC	GTCAGGCT
GCCTCAAT	GCCTAATA
GGCCGGGA	GCGCCGGG
GGCCGGGC	GCGCCGGG
GGCCGGGG	GCGCCGGG
GGCCGGGT	GCGCCGGG
GGCCGGGN	GCGCCGGG
GCCTCATA	GCCTAATA
GGGCACCA	GTGGCACC
GGGCACCC	GTGGCACC
GGGCACCG	GTGGCACC
GGGCACCT	GTGGCACC
GGGCACCN	GTGGCACC
GCCTCCAT	GCATCCAT
GGCCTAAT	GCCTAATA
GCCTCTCT	TCCTCTCT
GGAGGCAT	TGAGGCAT
GGAGGCCG	AGAGGCCG
GGTGGCAC	GTGGCACC
GGAAAATT	GAAAATTT
GGAGGGTA	GAAGGGTA
GCCTGAAT	GCCTAATA
GGTGGGGT	TGTGGGGT
GCCTGATA	GCCTAATA
GCNAGCTC	GCTAGCTC
GGTGGTTA	AGGTGGTT
GGTGGTTC	AGGTGGTT
GGTGGTTG	AGGTGGTT
GGTGGTTT	AGGTGGTT
GGTGGTTN	AGGTGGTT
GGGCCGGG	GCGCCGGG
GGAAATTT	GAAAATTT
GCCTGGTA	CCTGGTAC
GGAGTCGG	GAGTCGGT
GGGCGAAG	GCGCGAAG
GCCTGTTA	GCGTGTTA
GGAGTTTA	CGAGTTTA
GCNATCCA	GCATCCAT
GGTGTTAA	GCGTGTTA
GGTGTTAC	GCGTGTTA
GGTGTTAG	GCGTGTTA
GGTGTTAT	GCGTGTTA
GGTGTTAN	GCGTGTTA
GCCTTAAT	GCCTAATA
GCCTTATA	GCCTAATA
GGAAGGGT	GAAGGGTA
GGCGAAGA	GCGCGAAG
GGCGAAGC	GCGCGAAG
GGCGAAGG	GCGCGAAG
GGCGAAGT	GCGCGAAG
GGCGAAGN	GCGCGAAG
GCCTNAAT	GCCTAATA
GGGCTTAA	AGGCTTAA
GCCTNATA	GCCTAATA
GGTTAAAG	GTTTAAAG
GGATAGAA	GATAGAAA
GGCGCCGG	GCGCCGGG
GGTTGACT	GTTTGACT
GGCGCGAA	GCGCGAAG
GGAATTCG	GAATTCGT
GCCNAATA	GCCTAATA
GGATCCAT	GCATCCAT
GGGGAACC	CGGGAACC
GGTTTAAA	GTTTAAAG
GGTTTCCC	GATTTCCC
GGTTTGAC	GTTTGACT
GGGGCACC	GTGGCACC
GGTTTTGC	TGTTTTGC
GGCGTGTT	GCGTGTTA
GGATTCGT	GAATTCGT
GGATTTCC	GATTTCCC
GCCNTAAT	GCCTAATA
GTCAAAAG	GTCAAATG
GTCAAAAT	GTCAAATG
GTCAAACG	GTCAAATG
GTCAAACT	GTCAAATG
GTCAAAGA	GTCAAATG
GTCAAAGC	GTCAAATG
GTCAAAGG	GTCAAATG
GTCAAAGT	GTCAAATG
GTCAAAGN	GTCAAATG
GTCAAATA	GTCAAATG
GTCAAATC	GTCAAATG
GTCAAATG	GTCAAATG
GTCAAATT	GTCAAATG
GTCAAATN	GTCAAATG
GTCAAANG	GTCAAATG
GTCAAANT	GTCAAATG
GGGGTAGG	CGGGTAGG
GTCAACAA	TCAACAAC
GTCAACAT	GTCAAATG
GTCAACTG	GTCAAATG
GGCTAAAT	TGCTAAAT
GTCAAGAT	GTCAAATG
GGCTAATA	GCCTAATA
GTCAAGCT	GTCAGGCT
GTCAAGGC	GTCAGGCT
GTCAAGTG	GTCAAATG
GTCAATAT	GTCAAATG
GTCAATGA	GTCAAATG
GTCAATGC	GTCAAATG
GTCAATGG	GTCAAATG
GTCAATGT	GTCAAATG
GTCAATGN	GTCAAATG
GTCAATTG	GTCAAATG
GGCTAGCT	GCTAGCTC
GTCAANAT	GTCAAATG
GTCAANTG	GTCAAATG
GGTACCGA	GTACCGAA
GTCACAAT	GTCAAATG
GTCACATG	GTCAAATG
GTCACCGA	GTACCGAA
GTCACGCT	GTCAGGCT
GTCACGGC	GTCAGGCT
GGTAGAAA	GATAGAAA
GTCAGAAT	GTCAAATG
GGTAGCTC	GCTAGCTC
GTCAGACT	GTCAGGCT
GTCAGAGC	GTCAGGCT
GTCAGATG	GTCAAATG
GTCAGCCT	GTCAGGCT
GTCAGCGC	GTCAGGCT
GTCAGCTA	GTCAGGCT
GTCAGCTC	GTCAGGCT
GTCAGCTG	GTCAGGCT
GTCAGCTT	GTCAGGCT
GTCAGCTN	GTCAGGCT
GTACGAAA	GTACCGAA
GTACGAAC	GTACCGAA
GCNCCGGG	GCGCCGGG
GTACGAAG	GTACCGAA
GTACGAAT	GTACCGAA
GTACGAAN	GTACCGAA
GTCAGGAC	GTCAGGCT
GTCAGGAT	GTCAGGCT
GTCAGGCA	GTCAGGCT
GTCAGGCC	GTCAGGCT
GTCAGGCG	GTCAGGCT
GTCAGGCT	GTCAGGCT
GTCAGGCN	GTCAGGCT
GTCAGGGC	GTCAGGCT
GTCAGGGT	GTCAGGCT
GTCAGGTA	GTCAGGCT
GTCAGGTC	GTCAGGCT
GTCAGGTG	GTCAGGCT
GTCAGGTT	GTCAGGCT
GTCAGGTN	GTCAGGCT
GGGTAGGA	CGGGTAGG
GTCAGGNC	GTCAGGCT
GGGTAGGC	CGGGTAGG
GGGTAGGG	CGGGTAGG
GTCAGGNT	GTCAGGCT
GGGTAGGT	CGGGTAGG
GGGTAGGN	CGGGTAGG
GTACGCCC	TACGCCCA
GTCAGTCT	GTCAGGCT
GTACGCGA	GTACCGAA
GTCAGTGC	GTCAGGCT
GTACGGAA	GTACCGAA
GTCAGNCT	GTCAGGCT
GTCAGNGC	GTCAGGCT
GTACGGTA	TACGGTAT
GCNCGAAG	GCGCGAAG
GTCATAAT	GTCAAATG
GTCATATG	GTCAAATG
GTCATCCA	GCATCCAT
GGCTTAAA	AGGCTTAA
GGCTTAAC	AGGCTTAA
GGCTTAAG	AGGCTTAA
GGCTTAAT	AGGCTTAA
GGCTTAAN	AGGCTTAA
GTCATGCT	GTCAGGCT
GTCATGGC	GTCAGGCT
GGGTCGGT	GAGTCGGT
GGCTTCTT	AGCTTCTT
GTCATTAT	GACATTAT
GTACTCGA	GTACCGAA
GTACTGAA	GTACCGAA
GCNCTAAT	GCCTAATA
GTCANAAT	GTCAAATG
GTCANATG	GTCAAATG
GGGTGGTT	AGGTGGTT
GTCANGCT	GTCAGGCT
GTCANGGC	GTCAGGCT
GGTCAAAT	GTCAAATG
GGGTGTTA	GCGTGTTA
GTACNCGA	GTACCGAA
GTACNGAA	GTACCGAA
GTGCAAAT	GTCAAATG
GTCCAAAA	TTCCAAAA
GTCCAAAT	GTCAAATG
GGTCAGGC	GTCAGGCT
GTCCAATG	GTCAAATG
GTGCACCA	GTGGCACC
GTGCACCC	GTGGCACC
GTGCACCG	GTGGCACC
GTGCACCT	GTGGCACC
GTGCACCN	GTGGCACC
GTGCAGGC	GTCAGGCT
GTCCAGGC	GTCAGGCT
GTAGAAAA	GATAGAAA
GTAGAAAC	GATAGAAA
GTAGAAAG	GATAGAAA
GTAGAAAT	GATAGAAA
GTAGAAAN	GATAGAAA
GTCCCGAA	GTACCGAA
GTCCCGGC	TCCCGGCT
GTCCCGTC	GACCCGTC
GTGCCACC	GTGGCACC
GTAAAATG	GTCAAATG
GTAAAATT	GAAAATTT
GTTGGACT	GTTTGACT
GTGCCATG	TGCCATGT
GTTGGCAC	GTGGCACC
GTGCCGAA	GTACCGAA
GTCCGAAA	GTACCGAA
GTCCGAAC	GTACCGAA
GTCCGAAG	GTACCGAA
GTCCGAAT	GTACCGAA
GTCCGAAN	GTACCGAA
GTGCCGGG	GCGCCGGG
GTAAATGA	GTCAAATG
GTAAATGC	GTCAAATG
GTCCGCCA	ATCCGCCA
GTAAATGG	GTCAAATG
GTAAATGT	GTCAAATG
GTAAATGN	GTCAAATG
GTAAATTT	GAAAATTT
GTAGCACC	GTGGCACC
GTCCGGCT	GTCAGGCT
GTGCGAAG	GCGCGAAG
GTAGCCGA	GTACCGAA
GTTGTAAA	GTTTAAAG
GTAGCGAA	GTACCGAA
GTAACCAG	TAACCAGC
GTGCGCAC	GTGGCACC
GGTCGGTA	GAGTCGGT
GGTCGGTC	GAGTCGGT
GGTCGGTG	GAGTCGGT
GGTCGGTT	GAGTCGGT
GGTCGGTN	GAGTCGGT
GTAACCGA	GTACCGAA
GTTGTCCG	TTGTCCGA
GTAACGAA	GTACCGAA
GTAGCTCA	GCTAGCTC
GTAGCTCC	GCTAGCTC
GTAGCTCG	GCTAGCTC
GTCCTAAT	GCCTAATA
GTAGCTCT	GCTAGCTC
GTAGCTCN	GCTAGCTC
GTTGTGAC	GTTTGACT
GTCCTAGC	TCCTAGCG
GTTGTGGA	TTTGTGGA
GCNGCCGG	GCGCCGGG
GTGCGTTC	TTGCGTTC
GTCCTCTC	TCCTCTCT
GCNGCGAA	GCGCGAAG
GTAGGACG	TTAGGACG
GGTCTCAG	AGTCTCAG
GTGCTAAA	TGCTAAAT
GTAGGCAC	GTGGCACC
GTAAGATC	TAAGATCG
GTAGGCTA	GTCAGGCT
GTAGGCTC	GTCAGGCT
GTAGGCTG	GTCAGGCT
GTAGGCTT	GTCAGGCT
GTAGGCTN	GTCAGGCT
GTAGGGTA	GAAGGGTA
GTAAGGCT	GTCAGGCT
GTAAGGGT	GAAGGGTA
GTATAAAG	GTTTAAAG
GTATAAGG	TATAAGGG
GTTTAAAA	GTTTAAAG
GTTTAAAC	GTTTAAAG
GTTTAAAG	GTTTAAAG
GTTTAAAT	GTTTAAAG
GTATAGAA	GATAGAAA
GTTTAAAN	GTTTAAAG
GTTTAACA	GTTTAAAG
GTTTAACG	GTTTAAAG
GTTTAACT	GTTTGACT
GTTTAAGA	GTTTAAAG
GTTTAAGC	GTTTAAAG
GTTTAAGG	GTTTAAAG
GTTTAAGT	GTTTAAAG
GTTTAAGN	GTTTAAAG
GTTTAATA	GTTTAAAG
GTTTAATG	GTTTAAAG
GTTTAANA	GTTTAAAG
GTTTAANG	GTTTAAAG
GTTTACAA	GTTTAAAG
GTAGTCGG	GAGTCGGT
GTTTACAG	GTTTAAAG
GTTTACTA	GTTTGACT
GTTTACTC	GTTTGACT
GTTTACTG	GTTTGACT
GTTTACTT	GTTTGACT
GTTTACTN	GTTTGACT
GTCGAAAT	GTCAAATG
GTTTAGAA	GTTTAAAG
GTTTAGAC	GTTTGACT
GTTTAGAG	GTTTAAAG
GTCGAATG	GTCAAATG
GTAATTAC	TAATTACA
GTAATTCG	GAATTCGT
GTTTATAA	GTTTAAAG
GTTTATAG	GTTTAAAG
GTATCACT	TTATCACT
GTCGACTT	ATCGACTT
GTTTANAA	GTTTAAAG
GTTTANAG	GTTTAAAG
GTATCCAT	GCATCCAT
GTCGAGGC	GTCAGGCT
GTCGAGTC	TCGAGTCC
GTATCCGA	GTACCGAA
GTGGAACC	GTGGCACC
GTTTCAAA	GTTTAAAG
GTTTCAAG	GTTTAAAG
GTATCGAA	GTACCGAA
GTTTCACT	GTTTGACT
GTGGACAC	GTGGCACC
GTGGACCA	GTGGCACC
GTGGACCC	GTGGCACC
GTGGACCG	GTGGCACC
GTGGACCT	GTGGCACC
GTGGACCN	GTGGCACC
GTTTCCCA	GATTTCCC
GTTTCCCC	GATTTCCC
GTTTCCCG	GATTTCCC
GTTTCCCT	GATTTCCC
GTTTCCCN	GATTTCCC
GTGGAGAC	TGGAGACT
GTTTCGAC	GTTTGACT
GTCGCACC	GTGGCACC
GTCGCCGG	GCGCCGGG
GTATGACT	GTTTGACT
GTCGCGAA	GCGCGAAG
GTATGCAA	CTATGCAA
GTGGCAAC	GTGGCACC
GTACAAAT	GTCAAATG
GTGGCACA	GTGGCACC
GTGGCACC	GTGGCACC
GTGGCACG	GTGGCACC
GTGGCACT	GTGGCACC
GTGGCACN	GTGGCACC
GTTTGAAA	GTTTAAAG
GTGGCAGC	GTGGCACC
GTTTGAAC	GTTTGACT
GTTTGAAG	GTTTAAAG
GTTTGAAT	GTTTGACT
GTTTGACA	GTTTGACT
GTGGCATC	GTGGCACC
GTTTGACC	GTTTGACT
GTTTGACG	GTTTGACT
GTTTGACT	GTTTGACT
GTTTGACN	GTTTGACT
GTGGCANC	GTGGCACC
GTTTGAGC	GTTTGACT
GTTTGAGT	GTTTGACT
GTTTGATA	GTTTGACT
GTGGCCAC	GTGGCACC
GTTTGATC	GTTTGACT
GTTTGATG	GTTTGACT
GTTTGATT	GTTTGACT
GTTTGATN	GTTTGACT
GTGGCCCA	GTGGCACC
GTGNCACC	GTGGCACC
GTGGCCCC	GTGGCACC
GTTTGANC	GTTTGACT
GTGGCCCG	GTGGCACC
GTTTGANT	GTTTGACT
GTGGCCCT	GTGGCACC
GTGGCCCN	GTGGCACC
GTTTGCAC	GTTTGACT
GTACACGA	GTACCGAA
GTTTGCCT	GTTTGACT
GTTTGCTA	GTTTGACT
GTTTGCTC	GTTTGACT
GTGGCGAC	GTGGCACC
GTTTGCTG	GTTTGACT
GTACAGAA	GTACCGAA
GTTTGCTT	GTTTGACT
GTTTGCTN	GTTTGACT
GTGGCGCC	GTGGCACC
GTCGGAAA	ATCGGAAA
GTTTGGAC	GTTTGACT
GTACAGGC	GTCAGGCT
GTTTGGCT	GTTTGACT
GTGGCTAC	GTGGCACC
GTGGCTCC	GTGGCACC
GTCGGCAC	GTGGCACC
GTTTGTAC	GTTTGACT
GTATTAAA	GTTTAAAG
GTACATTA	GACATTAT
GTTTGTCT	GTTTGACT
GTCGGCTA	GTCAGGCT
GTTTGTGG	TTTGTGGA
GTCGGCTC	GTCAGGCT
GTCGGCTG	GTCAGGCT
GTCGGCTT	GTCAGGCT
GTCGGCTN	GTCAGGCT
GTGGCNAC	GTGGCACC
GTGGCNCC	GTGGCACC
GTTTGNAC	GTTTGACT
GTCGGGCT	GTCAGGCT
GTTTGNCT	GTTTGACT
GTACCAAA	GTACCGAA
GTACCAAC	GTACCGAA
GTATTCGT	GAATTCGT
GTACCAAG	GTACCGAA
GTACCAAT	GTACCGAA
GTGGGACC	GTGGCACC
GTACCAAN	GTACCGAA
GTTTTAAA	GTTTAAAG
GTACCAGA	GTACCGAA
GTTTTAAG	GTTTAAAG
GTATTGAC	GTTTGACT
GTTTTACT	GTTTGACT
GTGGGCAC	GTGGCACC
GTATTGGC	TATTGGCG
GTACCCAA	GTACCGAA
GTACCCGA	GTACCGAA
GTGGGCTA	ATGGGCTA
GTTTTCCC	GATTTCCC
GTACCCGT	GACCCGTC
GTATTTCC	GATTTCCC
GTACCGAA	GTACCGAA
GTACCGAC	GTACCGAA
GTACCGAG	GTACCGAA
GTACCGAT	GTACCGAA
GTACCGAN	GTACCGAA
GTACCGCA	GTACCGAA
GTTTTGAC	GTTTGACT
GTACCGGA	GTACCGAA
GTGGGGTA	TGTGGGGT
GTTTTGCA	TGTTTTGC
GTGGGGTC	TGTGGGGT
GTTTTGCC	TGTTTTGC
GTGGGGTG	TGTGGGGT
GTTTTGCG	TGTTTTGC
GTGGGGTT	TGTGGGGT
GTTTTGCT	TGTTTTGC
GTGGGGTN	TGTGGGGT
GTGNGCAC	GTGGCACC
GTTTTGCN	TGTTTTGC
GTACCGTA	GTACCGAA
GTACCGNA	GTACCGAA
GTACCTAA	GTACCGAA
GTACCTGA	GTACCGAA
GTCGTCTG	TCGTCTGG
GTACCNAA	GTACCGAA
GTACCNGA	GTACCGAA
GTCGTGTT	GCGTGTTA
GTTTNAAA	GTTTAAAG
GTGGTACC	GTGGCACC
GTTTNAAG	GTTTAAAG
GTTTNACT	GTTTGACT
GTGGTCAC	GTGGCACC
GTCTAAAG	GTTTAAAG
GTCTAAAT	GTCAAATG
GTTNAAAG	GTTTAAAG
GTTTNGAC	GTTTGACT
GTCTAATA	GCCTAATA
GTCTAATG	GTCAAATG
GTCTAGCT	GCTAGCTC
GTCTAGGC	GTCAGGCT
GTGGNACC	GTGGCACC
GTGGNCAC	GTGGCACC
GTCTCAGA	AGTCTCAG
GTCTCAGC	AGTCTCAG
GTCTCAGG	AGTCTCAG
GTCTCAGT	AGTCTCAG
GTCTCAGN	AGTCTCAG
GTCTCCAT	CTCTCCAT
GTANCCGA	GTACCGAA
GTGTAAAG	GTTTAAAG
GTANCGAA	GTACCGAA
GTCTGACT	GTTTGACT
GTTNGACT	GTTTGACT
GNCAGGCT	GTCAGGCT
GTGTAGTC	CTGTAGTC
GTTAAAAG	GTTTAAAG
GTTAAAGA	GTTTAAAG
GTTAAAGC	GTTTAAAG
GTTAAAGG	GTTTAAAG
GTTAAAGT	GTTTAAAG
GTTAAAGN	GTTTAAAG
GTTAAATG	GTCAAATG
GGGAACCA	CGGGAACC
GGGAACCC	CGGGAACC
GGGAACCG	CGGGAACC
GGGAACCT	CGGGAACC
GGGAACCN	CGGGAACC
GTCTGGCT	GTCAGGCT
GTGTCACC	GTGGCACC
GTGTCCGA	TTGTCCGA
GNCATCCA	GCATCCAT
GTTAATGA	CTTAATGA
GTCTTAAA	GTTTAAAG
GTGTCGGT	GAGTCGGT
GNCATTAT	GACATTAT
GTTNTAAA	GTTTAAAG
GTCTTGAC	GTTTGACT
GTCTTTAA	CTCTTTAA
GTTACCGA	GTACCGAA
GTTACCGG	CTTACCGG
GTGTGACT	GTTTGACT
GTGTGCAC	GTGGCACC
GTTNTGAC	GTTTGACT
GTGTGGGG	TGTGGGGT
GTTCAAAG	GTTTAAAG
GTTCAAAT	GTCAAATG
GTTCAACC	ATTCAACC
GTGTGTTA	GCGTGTTA
GTTAGAAA	GATAGAAA
GTTAGACT	GTTTGACT
GTGTTAAA	GTTTAAAG
GTTCAGGC	GTCAGGCT
GTTAGCTC	GCTAGCTC
GTTAGGAC	TTAGGACG
GTTAGGCT	GTCAGGCT
GTGTTGAC	GTTTGACT
GTCNAAAT	GTCAAATG
GTCNAATG	GTCAAATG
GTTCCAAA	TTCCAAAA
GTGTTTTG	TGTTTTGC
GTCNAGGC	GTCAGGCT
GTTATAAA	GTTTAAAG
GNAAAATT	GAAAATTT
GTTCCGAA	GTACCGAA
GTTATATC	ATTATATC
GTNAAATG	GTCAAATG
GTTATCAC	TTATCACT
GTTCCTGA	ATTCCTGA
GTTATGAC	GTTTGACT
GNCCCGTC	GACCCGTC
GNAAATTT	GAAAATTT
GTTCGACT	GTTTGACT
GTNACCGA	GTACCGAA
GTTCTAAA	GTTTAAAG
GTTCTGAC	GTTTGACT
GNCCTAAT	GCCTAATA
GTNAGGCT	GTCAGGCT
GNAAGGGT	GAAGGGTA
GNTTAAAG	GTTTAAAG
GTNCAAAT	GTCAAATG
GTTGAAAG	GTTTAAAG
GNAATTCG	GAATTCGT
GTTGACAG	TTGACAGC
GNAGGGTA	GAAGGGTA
GTTGACTA	GTTTGACT
GTTGACTC	GTTTGACT
GTTGACTG	GTTTGACT
GTTGACTT	GTTTGACT
GTNCAGGC	GTCAGGCT
GTTGACTN	GTTTGACT
GTTGCACC	GTGGCACC
GNAGTCGG	GAGTCGGT
GTNCCGAA	GTACCGAA
GNGGCACC	GTGGCACC
GNTTGACT	GTTTGACT
GTTGCGTT	TTGCGTTC
GNCGCCGG	GCGCCGGG
GNCGCGAA	GCGCGAAG
GNACATTA	GACATTAT
GNATTCGT	GAATTCGT
GNTTTAAA	GTTTAAAG
GNATTTCC	GATTTCCC
GNACCCGT	GACCCGTC
GNTTTCCC	GATTTCCC
GNACCGAA	GTACCGAA
GNTTTGAC	GTTTGACT
GNATAGAA	GATAGAAA
GTCNGGCT	GTCAGGCT
GNCGTGTT	GCGTGTTA
GNATCCAT	GCATCCAT
GTGAAATG	GTCAAATG
GNCTAATA	GCCTAATA
GNGTCGGT	GAGTCGGT
GNCTAGCT	GCTAGCTC
GTGACACC	GTGGCACC
GTGACAGC	TTGACAGC
GTGACCGA	GTACCGAA
GNGTGTTA	GCGTGTTA
TACCAAAA	TTCCAAAA
GTGAGCAC	GTGGCACC
GTGAGGCA	TGAGGCAT
GTGAGGCT	GTCAGGCT
GNTACCGA	GTACCGAA
TACCAGAG	CACCAGAG
TACCAGCA	TAACCAGC
TACCAGCC	TAACCAGC
TACCAGCG	TAACCAGC
TACCAGCT	TAACCAGC
TACCAGCN	TAACCAGC
TACCATGT	TGCCATGT
TAAAACAT	AAAACATG
GNTAGAAA	GATAGAAA
TACCCAGC	TAACCAGC
TAAAAGGG	TATAAGGG
GNCAAATG	GTCAAATG
TACCCCAA	TACGCCCA
TACCCCAC	TACGCCCA
TACCCCAG	TACGCCCA
TACCCCAT	TACGCCCA
TACCCCAN	TACGCCCA
TACCCCCA	TACGCCCA
TAAAATCC	AAAATCCC
TAAAATCG	TAAGATCG
TAAAATTT	GAAAATTT
TACCCGAA	ACCCGAAC
GNTAGCTC	GCTAGCTC
TACCCGGC	TCCCGGCT
TACCCGTC	GACCCGTC
TAAACAAC	TCAACAAC
TACCCTGG	AACCCTGG
TAAACAGC	TAACCAGC
TAAACATG	AAAACATG
TAAACCAG	TAACCAGC
TACCGAAA	GTACCGAA
TACCGAAC	GTACCGAA
TACCGAAG	GTACCGAA
TACCGAAT	GTACCGAA
TACCGAAN	GTACCGAA
TAAACGTT	AAACGTTC
TAAACTAA	AAACTAAC
TACCGCCC	TACGCCCA
TACCGGCT	TCCCGGCT
TACCGGTA	TACGGTAT
TACCGTAT	TACGGTAT
TAAAGATC	TAAGATCG
GTNGCACC	GTGGCACC
TAAAGGGA	TATAAGGG
TAAAGGGC	TATAAGGG
TAAAGGGG	TATAAGGG
TACCTAGC	TCCTAGCG
TAAAGGGT	TATAAGGG
TAAAGGGN	TATAAGGG
TACCTCTC	TCCTCTCT
TAAATACA	TAATTACA
TACCTTCG	CACCTTCG
TAAATCCC	AAAATCCC
TAAATCGA	TAAGATCG
TAAATCGC	TAAGATCG
TAAATCGG	TAAGATCG
TAAATCGT	TAAGATCG
TAAATCGN	TAAGATCG
GTNGGCAC	GTGGCACC
TAAATGTA	AAATGTAG
TAAATTAC	TAATTACA
TAAATTGG	CAAATTGG
GNTCAAAT	GTCAAATG
GNTCAGGC	GTCAGGCT
TACGACCA	TACGCCCA
TACGACCC	TACGCCCA
TACGAGTA	TACGGTAT
TACGAGTC	TCGAGTCC
TACGATAC	ACGATACG
TACGATAT	TACGGTAT
TAGGCATA	TGAGGCAT
TACGATCG	TAAGATCG
TAGGCATC	TGAGGCAT
TAGGCATG	TGAGGCAT
TAGGCATT	TGAGGCAT
TAGGCATN	TGAGGCAT
TAACAACA	TCAACAAC
TAACAACC	TCAACAAC
TAACAACG	TCAACAAC
TAACAACT	TCAACAAC
TAACAACN	TCAACAAC
TAACAAGC	TAACCAGC
TAGGCCCA	TACGCCCA
TAACACAG	TAACCAGC
TACGCACA	TACGCCCA
TACGCACC	TACGCCCA
TAACAGCA	TAACCAGC
TAACAGCC	TAACCAGC
TAACAGCG	TAACCAGC
TAACAGCT	TAACCAGC
TAACAGCN	TAACCAGC
TACGCCAA	TACGCCCA
TACGCCAC	TACGCCCA
TACGCCAG	TACGCCCA
TACGCCAT	TACGCCCA
TACGCCAN	TACGCCCA
TACGCCCA	TACGCCCA
TAGGCTTA	AGGCTTAA
TACGCCCC	TACGCCCA
TACGCCCG	TACGCCCA
TACGCCCT	TACGCCCA
TACGCCCN	TACGCCCA
TACGCCGA	TACGCCCA
TACGCCGC	TACGCCCA
TAACATCG	TAAGATCG
TACGCCTA	TACGCCCA
TACGCCTC	TACGCCCA
TACGCCNA	TACGCCCA
TACGCCNC	TACGCCCA
TACGCGCA	TACGCCCA
TACGCGCC	TACGCCCA
TACGCGTA	TACGGTAT
TAAGTACA	TAATTACA
TACGCTAT	TACGGTAT
TAAGTATC	TAAGATCG
TACGCTCA	TACGCCCA
TACGCTCC	TACGCCCA
TAACCAAC	TAACCAGC
TAACCAAG	TAACCAGC
TAACCACA	TAACCAGC
GTNTAAAG	GTTTAAAG
TAACCACC	TAACCAGC
TAACCACG	TAACCAGC
TAACCACT	TAACCAGC
TAACCACN	TAACCAGC
TAACCAGA	TAACCAGC
TAACCAGC	TAACCAGC
TAACCAGG	TAACCAGC
TAACCAGT	TAACCAGC
TAACCAGN	TAACCAGC
TAACCATC	TAACCAGC
TAACCATG	TAACCAGC
TAAGTCGA	TAAGATCG
TAAGTCGC	TAAGATCG
TAACCANC	TAACCAGC
TAAGTCGG	TAAGATCG
TAACCANG	TAACCAGC
TAAGTCGT	TAAGATCG
TAAGTCGN	TAAGATCG
TACGCNCA	TACGCCCA
TACGCNCC	TACGCCCA
TAACCCAG	TAACCAGC
TAACCCGC	TAACCAGC
TAACCCTG	AACCCTGG
TATTTACA	TAATTACA
TAACCGAG	TAACCAGC
TAACCGCA	TAACCAGC
TAACCGCC	TAACCAGC
TAACCGCG	TAACCAGC
TAGGGTAT	TACGGTAT
TAACCGCT	TAACCAGC
TAACCGCN	TAACCAGC
TAACCGGC	TAACCAGC
GNTGGCAC	GTGGCACC
TAAGTTAC	TAATTACA
TAAGTTCG	TAAGATCG
TAAGTTGC	AAGTTGCG
TAACCTAG	TAACCAGC
TATTTCCC	GATTTCCC
TAACCTGC	TAACCAGC
TAACCNAG	TAACCAGC
TATTTGCG	TATTGGCG
TAACCNGC	TAACCAGC
TATTTGGC	TATTGGCG
TAGGTATA	TACGGTAT
TAGGTATC	TACGGTAT
TAGGTATG	TACGGTAT
TAGGTATT	TACGGTAT
TAGGTATN	TACGGTAT
TAACGAGC	TAACCAGC
TAAGNATC	TAAGATCG
TATTTTGC	TGTTTTGC
TAACGATC	TAAGATCG
TAACGCAG	TAACCAGC
TAACGCCC	TACGCCCA
TAGGTGGT	AGGTGGTT
TAACGGTA	TACGGTAT
TAAGNTCG	TAAGATCG
TAACGTTC	AAACGTTC
TATTNGCG	TATTGGCG
TAACTAAC	AAACTAAC
TATTNGGC	TATTGGCG
TAACTACA	TAATTACA
TAACTAGC	TAACCAGC
GTNTGACT	GTTTGACT
TAATAACA	TAATTACA
TAATAAGG	TATAAGGG
TAACTCAG	TAACCAGC
TAATACAA	TAATTACA
TAATACAC	TAATTACA
TAATACAG	TAATTACA
TAATACAT	TAATTACA
TAATACAN	TAATTACA
TACGGAAT	TACGGTAT
TACGGATA	TACGGTAT
TACGGATC	TACGGTAT
TACGGATG	TACGGTAT
TACGGATT	TACGGTAT
TACGGATN	TACGGTAT
TAATAGCT	AATAGCTT
TAACTTAC	TAATTACA
TATNAAGG	TATAAGGG
TACGGCAT	TACGGTAT
TACGGCCA	TACGCCCA
TACGGCCC	TACGCCCA
TACGGCTA	TACGGTAT
TAATATAC	TAATTACA
TAATATCG	TAAGATCG
TACGGGAT	TACGGTAT
TAGTAAGG	TATAAGGG
TACGGGTA	TACGGTAT
GTNTTAAA	GTTTAAAG
TACGGTAA	TACGGTAT
TACGGTAC	TACGGTAT
TATNAGGG	TATAAGGG
TACGGTAG	TACGGTAT
TACGGTAT	TACGGTAT
TACGGTAN	TACGGTAT
TACGGTCA	TACGGTAT
TAACNAGC	TAACCAGC
TACGGTCT	TACGGTAT
TACGGTGA	TACGGTAT
TACGGTGT	TACGGTAT
TACGGTTA	TACGGTAT
TACGGTTC	TACGGTAT
TACGGTTG	TACGGTAT
TACGGTTT	TACGGTAT
TACGGTTN	TACGGTAT
TACGGTNA	TACGGTAT
TAACNCAG	TAACCAGC
TACGGTNT	TACGGTAT
TAATCACA	TAATTACA
TACGGNAT	TACGGTAT
TAATCACT	TTATCACT
TAATCAGC	TAACCAGC
TAANCAGC	TAACCAGC
TACGGNTA	TACGGTAT
GTNTTGAC	GTTTGACT
TAATCCAG	TAACCAGC
TAANCCAG	TAACCAGC
TACGTATA	TACGGTAT
TACGTATC	TACGGTAT
TACGTATG	TACGGTAT
TACGTATT	TACGGTAT
TACGTATN	TACGGTAT
TACGTCCA	TACGCCCA
TACGTCCC	TACGCCCA
TACGTCTG	TCGTCTGG
TAATCTAC	TAATTACA
TACGTGTA	TACGGTAT
TAAGAACG	TAAGATCG
TAGTCCGA	TTGTCCGA
TACGTTAT	TACGGTAT
TAAGAATC	TAAGATCG
TAAGACCG	TAAGATCG
TAAGACGA	TAAGATCG
TAAGACGC	TAAGATCG
TAGTCGGT	GAGTCGGT
TAAGACGG	TAAGATCG
TAAGACGT	TAAGATCG
TAAGACGN	TAAGATCG
TAAGACTC	TAAGATCG
TAATGACA	TAATTACA
TAATGACC	AATGACCG
TAANGATC	TAAGATCG
TAGTCTCA	AGTCTCAG
TAAGAGCG	TAAGATCG
TAATGATC	TAAGATCG
TAGTCTGG	TCGTCTGG
TAAGAGTC	TAAGATCG
TAAGATAC	TAAGATCG
TAAGATAG	TAAGATCG
TAAGATCA	TAAGATCG
TAAGATCC	TAAGATCG
TAAGATCG	TAAGATCG
TAAGATCT	TAAGATCG
TAAGATCN	TAAGATCG
TAAGATGA	TAAGATCG
TAAGATGC	TAAGATCG
TACGNCCA	TACGCCCA
TAAGATGG	TAAGATCG
TACGNCCC	TACGCCCA
TAAGATGT	TAAGATCG
TAAGATGN	TAAGATCG
TAAGATTC	TAAGATCG
TAAGATTG	TAAGATCG
TAAGATNC	TAAGATCG
TAAGATNG	TAAGATCG
TAATGGCG	TATTGGCG
TAAGANCG	TAAGATCG
TAAGANTC	TAAGATCG
TACGNGTA	TACGGTAT
TATNGGCG	TATTGGCG
TAATGTAC	TAATTACA
TAATGTAG	AAATGTAG
TACGNTAT	TACGGTAT
TAAGCAGC	TAACCAGC
TAAGCATC	TAAGATCG
TAAGCCAG	TAACCAGC
TAGTGGCG	TATTGGCG
TAAGCCCA	TACGCCCA
TAGTGGGG	TGTGGGGT
TAANTACA	TAATTACA
TAATTAAA	TAATTACA
TAATTAAC	TAATTACA
TAATTAAG	TAATTACA
TAATTAAT	TAATTACA
TAATTAAN	TAATTACA
TAATTACA	TAATTACA
TACTAAAT	TGCTAAAT
TAATTACC	TAATTACA
TAATTACG	TAATTACA
TAATTACT	TAATTACA
TAATTACN	TAATTACA
TAATTAGA	TAATTACA
TAATTAGC	TAATTACA
TACTAAGC	ACTAAGCG
TACTAAGG	TATAAGGG
TAATTATA	TAATTACA
TAATTATC	TAATTACA
TAATTANA	TAATTACA
TAATTANC	TAATTACA
TAAGCTCG	TAAGATCG
TAATTCAA	TAATTACA
TAATTCAC	TAATTACA
TAATTCAG	TAATTACA
TAATTCAT	TAATTACA
TAATTCAN	TAATTACA
TAATTCCA	TAATTACA
TAATTCGT	GAATTCGT
TAGTTACA	TAATTACA
TAANTTAC	TAATTACA
TAATTGAC	TAATTACA
TACTAGCG	TCCTAGCG
TAATTGCA	TAATTACA
TAATTGGC	TATTGGCG
TACTAGTT	CACTAGTT
TATNTGGC	TATTGGCG
TAAGGACG	TTAGGACG
TAAGGATC	TAAGATCG
TAATTTAC	TAATTACA
TAATTTCA	TAATTACA
TAGTTGCG	AAGTTGCG
TAAGGCAT	TGAGGCAT
TAGTTGGC	TATTGGCG
TAATTNAC	TAATTACA
TAATTNCA	TAATTACA
TAGTTTTG	TGTTTTGC
TAAGGGTA	GAAGGGTA
TAATNACA	TAATTACA
TAAGGTAT	TACGGTAT
TAAGGTCC	CAAGGTCC
TAAGGTCG	TAAGATCG
TACTCCCA	TACGCCCA
TCAAAAAC	TCAACAAC
TCAAAACA	TCAACAAC
TCAAAACC	TCAACAAC
TCAAAACG	TCAACAAC
TCAAAACT	TCAACAAC
TCAAAACN	TCAACAAC
TCAAACAA	TCAACAAC
TACTCTCT	TCCTCTCT
TCAAAGAG	CCAAAGAG
TAATNTAC	TAATTACA
TCAAATGA	GTCAAATG
TCAAATGC	GTCAAATG
TCAAATGG	GTCAAATG
TCAAATGT	GTCAAATG
TCAAATGN	GTCAAATG
TACAACAA	TCAACAAC
TCAAATTG	CAAATTGG
TACTGCCC	TACGCCCA
TCAACAAA	TCAACAAC
TCAACAAC	TCAACAAC
TCAACAAG	TCAACAAC
TACAAGGG	TATAAGGG
TCAACAAT	TCAACAAC
TCAACAAN	TCAACAAC
TCAACACA	TCAACAAC
TCAACACC	TCAACAAC
TCAACACG	TCAACAAC
TCAACACT	TCAACAAC
TCAACACN	TCAACAAC
TCAACAGA	TCAACAAC
TCAACAGC	TCAACAAC
TCAACATA	TCAACAAC
TCAACATC	TCAACAAC
TCAACANA	TCAACAAC
TCAACANC	TCAACAAC
TACTGGCG	TATTGGCG
TCAACCAA	TCAACAAC
TCAACCAC	TCAACAAC
TCAACCAG	TAACCAGC
TACTGGTA	TACGGTAT
TANAAGGG	TATAAGGG
TACNCCCA	TACGCCCA
TACTGTAT	TACGGTAT
TCAACGAA	TCAACAAC
TCAACGAC	TCAACAAC
TCAACTAA	TCAACAAC
TCAACTAC	TCAACAAC
TAANATCG	TAAGATCG
TACACCAG	TAACCAGC
TACACCCA	TACGCCCA
TCCCGAAC	ACCCGAAC
TACTTACA	TAATTACA
TCAACNAA	TCAACAAC
TCAACNAC	TCAACAAC
TCCCGACT	TCCCGGCT
TCCCGAGC	TCCCGGCT
TCAAGAAC	TCAACAAC
TCCCGCCT	TCCCGGCT
TATAGAAA	GATAGAAA
TCCCGCGC	TCCCGGCT
TCCCGCTA	TCCCGGCT
TCCCGCTC	TCCCGGCT
TCCCGCTG	TCCCGGCT
TCCCGCTT	TCCCGGCT
TCCCGCTN	TCCCGGCT
TCAAGATC	TAAGATCG
TATAGAGG	TATAAGGG
TCCCGGAC	TCCCGGCT
TATAGATC	TAAGATCG
TCCCGGAT	TCCCGGCT
TCAAGCAA	TCAACAAC
TCCCGGCA	TCCCGGCT
TCCCGGCC	TCCCGGCT
TCCCGGCG	TCCCGGCT
TCCCGGCT	TCCCGGCT
TCCCGGCN	TCCCGGCT
TACTTGGC	TATTGGCG
TCCCGGGC	TCCCGGCT
TCCCGGGT	TCCCGGCT
TCCCGGTA	TCCCGGCT
TCCCGGTC	TCCCGGCT
TCCCGGTG	TCCCGGCT
TCCCGGTT	TCCCGGCT
TCCCGGTN	TCCCGGCT
TCCCGGNC	TCCCGGCT
TCCCGGNT	TCCCGGCT
TACNGCCC	TACGCCCA
TCCCGTCT	TCCCGGCT
TATAGCTT	AATAGCTT
TCCCGTGC	TCCCGGCT
TATAGGAC	TTAGGACG
TCAAGGTC	CAAGGTCC
TATAGGCG	TATTGGCG
TATAGGGA	TATAAGGG
TATAGGGC	TATAAGGG
TATAGGGG	TATAAGGG
TATAGGGT	TATAAGGG
TATAGGGN	TATAAGGG
TCCCGNCT	TCCCGGCT
TACAGATC	TAAGATCG
TCAAGTCC	TCGAGTCC
TCCCGNGC	TCCCGGCT
TACNGGTA	TACGGTAT
TACAGCCC	TACGCCCA
TACNGTAT	TACGGTAT
TCCCTAGC	TCCTAGCG
TACAGGAC	ACAGGACT
TCAATAAC	TCAACAAC
TACAGGTA	TACGGTAT
TCCCTCTA	TCCTCTCT
TCCCTCTC	TCCTCTCT
TCCCTCTG	TCCTCTCT
TCCCTCTT	TCCTCTCT
TCCCTCTN	TCCTCTCT
TACAGTAT	TACGGTAT
TCAATCAA	TCAACAAC
TCCCTGCT	TCCCGGCT
TCCCTGGC	TCCCGGCT
TATATAGG	TATAAGGG
TATATCAC	TTATCACT
TCAATTAC	TAATTACA
TATATGGC	TATTGGCG
GNGCCGGG	GCGCCGGG
TATATGGG	TATAAGGG
TATATTAC	TAATTACA
TCAANAAC	TCAACAAC
TANACCAG	TAACCAGC
TACATTAC	TAATTACA
TACATTAT	GACATTAT
TCAANCAA	TCAACAAC
TCCCNGCT	TCCCGGCT
TCCCNGGC	TCCCGGCT
GNGCGAAG	GCGCGAAG
TATANAGG	TATAAGGG
TATGAAGG	TATAAGGG
TATGACAG	TTGACAGC
TATGACCG	AATGACCG
TATANGGG	TATAAGGG
TATGAGGG	TATAAGGG
TCACAACA	TCAACAAC
TCACAACC	TCAACAAC
TCCGACGG	CCGACGGA
TCACAACG	TCAACAAC
TCACAACT	TCAACAAC
TCACAACN	TCAACAAC
TATGATCG	TAAGATCG
TCACACAA	TCAACAAC
TCCGAGCG	TCCTAGCG
TCCGAGTC	TCGAGTCC
TATGCAAA	CTATGCAA
TATCAAGG	TATAAGGG
TATGCAAC	CTATGCAA
TATGCAAG	CTATGCAA
TATGCAAT	CTATGCAA
TATGCAAN	CTATGCAA
TATGCCCA	TACGCCCA
TATCACTA	TTATCACT
TATCACTC	TTATCACT
TAGAAGGG	TATAAGGG
TATCACTG	TTATCACT
TATCACTT	TTATCACT
TATCACTN	TTATCACT
TCCGCCAA	ATCCGCCA
TCCGCCAC	ATCCGCCA
TCCGCCAG	ATCCGCCA
TATCAGGG	TATAAGGG
TCCGCCAT	ATCCGCCA
TCCGCCAN	ATCCGCCA
TCCGCCCA	TACGCCCA
TCACCAAC	TCAACAAC
TCCGCCCT	CCGCCCTA
TANAGATC	TAAGATCG
TATGCGTT	TTGCGTTC
TCACCAGA	CACCAGAG
TCACCAGC	TAACCAGC
TCCGCGGC	TCCCGGCT
TATAAAGG	TATAAGGG
TAGACAGC	TTGACAGC
TCCGCTCT	TCCTCTCT
TCACCGGC	TCCCGGCT
TATCCAAA	TTCCAAAA
TAGACCAG	TAACCAGC
TATAACGG	TATAAGGG
TATCCAGC	TAACCAGC
TATAAGAG	TATAAGGG
TATAAGCG	TATAAGGG
TATAAGGA	TATAAGGG
TATAAGGC	TATAAGGG
TATAAGGG	TATAAGGG
TCACCTTC	CACCTTCG
TATAAGGT	TATAAGGG
TATAAGGN	TATAAGGG
TATAAGTG	TATAAGGG
TATGGCGA	TATTGGCG
TATAAGNG	TATAAGGG
TATGGCGC	TATTGGCG
TATGGCGG	TATTGGCG
TATGGCGT	TATTGGCG
TATGGCGN	TATTGGCG
TATAATGG	TATAAGGG
TATGGGCG	TATTGGCG
TATGGGCT	ATGGGCTA
TATCCGCC	ATCCGCCA
TATGGGGT	TGTGGGGT
TCCGGCTA	TCCCGGCT
TCCGGCTC	TCCCGGCT
TCCGGCTG	TCCCGGCT
TCCGGCTT	TCCCGGCT
TCCGGCTN	TCCCGGCT
TATAANGG	TATAAGGG
TATGGTAT	TACGGTAT
TCCGGGCG	CCGGGCGT
TCCGGGCT	TCCCGGCT
TCACGCCC	TACGCCCA
TATACAGG	TATAAGGG
TCCGGTAT	TACGGTAT
TAGAGACT	TGGAGACT
TANATTAC	TAATTACA
TAGAGATC	TAAGATCG
TATACCAG	TAACCAGC
TCACGGCT	TCCCGGCT
TCACGGTA	TACGGTAT
TATCGACT	ATCGACTT
TATACGGG	TATAAGGG
TAGAGGCA	TGAGGCAT
TAGAGGCC	AGAGGCCG
TATGTCCG	TTGTCCGA
TCCGTAGC	TCCTAGCG
TATCGCCC	TACGCCCA
TAGAGTCC	TCGAGTCC
TATGTGGA	TTTGTGGA
TATGTGGC	TATTGGCG
TATCGGAA	ATCGGAAA
TCCGTCTC	TCCTCTCT
TCCGTCTG	TCGTCTGG
TATCGGCG	TATTGGCG
TATCGGTA	TACGGTAT
TCACTAGC	TCCTAGCG
TCACTAGT	CACTAGTT
TCCGTTGA	CCGTTGAA
TCACTCTC	TCCTCTCT
TATCTGGC	TATTGGCG
TCGTACTG	TCGTCTGG
TCGTAGCG	TCCTAGCG
TCGTAGTC	TCGAGTCC
TATTAAGG	TATAAGGG
TCGTATGG	TCGTCTGG
TATTACAA	TAATTACA
TATTACAC	TAATTACA
TATTACAG	TAATTACA
TATTACAT	TAATTACA
TATTACAN	TAATTACA
TANCCAGC	TAACCAGC
TATTAGCG	TATTGGCG
TATTAGGC	TATTGGCG
TATTAGGG	TATAAGGG
TANGATCG	TAAGATCG
TCGTCAGG	TCGTCTGG
TATTATAT	ATTATATC
TCGTCATG	TCGTCTGG
TCGTCCGA	TTGTCCGA
TCGTCCGG	TCGTCTGG
TCGTCCTG	TCGTCTGG
TCAGACAA	TCAACAAC
TCGTCGGA	TCGTCTGG
TCGTCGGC	TCGTCTGG
TCGTCGGG	TCGTCTGG
TCGTCGGT	TCGTCTGG
TCGTCGGN	TCGTCTGG
TATTCAAC	ATTCAACC
TCGTCGTG	TCGTCTGG
TANGCCCA	TACGCCCA
TCGTCTAG	TCGTCTGG
TCGTCTCG	TCGTCTGG
TCGTCTCT	TCCTCTCT
TCGTCTGA	TCGTCTGG
TCGTCTGC	TCGTCTGG
TCGTCTGG	TCGTCTGG
TCGTCTGT	TCGTCTGG
TCGTCTGN	TCGTCTGG
TCGTCTTG	TCGTCTGG
TCAGAGTC	TCGAGTCC
TCGTCTNG	TCGTCTGG
TCAGATAA	CAGATAAT
TATTCCTG	ATTCCTGA
TCAGATCG	TAAGATCG
TCGTCNGG	TCGTCTGG
TCGTCNTG	TCGTCTGG
TATTCGCG	TATTGGCG
TCATCAAC	TCAACAAC
TATTCGGC	TATTGGCG
TCATCACT	TTATCACT
TANCGCCC	TACGCCCA
TCATCCAT	GCATCCAT
TCAGCAAC	TCAACAAC
TCGTGCTG	TCGTCTGG
TANCGGTA	TACGGTAT
TCGTGGGG	TGTGGGGT
TATTGACG	TATTGGCG
TATTGAGC	TATTGGCG
TCGTGTCC	TCGAGTCC
TCATCTCT	TCCTCTCT
TCGTGTGG	TCGTCTGG
TCGTGTTA	GCGTGTTA
TCATCTGG	TCGTCTGG
TATTGCCG	TATTGGCG
TATTGCGA	TATTGGCG
TATTGCGC	TATTGGCG
TATTGCGG	TATTGGCG
TATTGCGT	TATTGGCG
TATTGCGN	TATTGGCG
TATTGGAC	TATTGGCG
TATTGGAG	TATTGGCG
TATTGGCA	TATTGGCG
TATTGGCC	TATTGGCG
TATTGGCG	TATTGGCG
TATTGGCT	TATTGGCG
TATTGGCN	TATTGGCG
TATTGGGA	TATTGGCG
TATTGGGC	TATTGGCG
TATTGGGG	TATTGGCG
TATTGGGT	TATTGGCG
TATTGGGN	TATTGGCG
TANGGTAT	TACGGTAT
TATTGGTC	TATTGGCG
TATTGGTG	TATTGGCG
TATTGGNC	TATTGGCG
TATTGGNG	TATTGGCG
TATTGTCG	TATTGGCG
TATTGTGC	TATTGGCG
TATTGTGG	TTTGTGGA
TCAGGACG	TTAGGACG
TCAGGACT	ACAGGACT
TCGTTCTG	TCGTCTGG
TATTGNCG	TATTGGCG
TATTGNGC	TATTGGCG
TCGTTGAA	CCGTTGAA
TCAGGCAT	TGAGGCAT
TCGTTGGA	TCGTCTGG
TCGTTGGC	TCGTCTGG
TCGTTGGG	TCGTCTGG
TCGTTGGT	TCGTCTGG
TCGTTGGN	TCGTCTGG
TCAGGCTA	GTCAGGCT
TCAGGCTC	GTCAGGCT
TCAGGCTG	GTCAGGCT
TCAGGCTT	GTCAGGCT
TCAGGCTN	GTCAGGCT
TCGTTTGG	TCGTCTGG
TCGTTTTG	TGTTTTGC
TCCTAAAT	TGCTAAAT
TCCTAACG	TCCTAGCG
TCCTAAGC	TCCTAGCG
TCCTAATA	GCCTAATA
TCCTACCG	TCCTAGCG
TCCTACGA	TCCTAGCG
TCCTACGC	TCCTAGCG
TCCTACGG	TCCTAGCG
TCCTACGT	TCCTAGCG
TCCTACGN	TCCTAGCG
TCCTACTC	TCCTCTCT
TCATTACA	TAATTACA
TCCTAGAC	TCCTAGCG
TCCTAGAG	TCCTAGCG
TCCTAGCA	TCCTAGCG
TCCTAGCC	TCCTAGCG
TCCTAGCG	TCCTAGCG
TCGTNCTG	TCGTCTGG
TCCTAGCT	TCCTAGCG
TCCTAGCN	TCCTAGCG
TCCTAGGA	TCCTAGCG
TCCTAGGC	TCCTAGCG
TCCTAGGG	TCCTAGCG
TCCTAGGT	TCCTAGCG
TCCTAGGN	TCCTAGCG
TCCTAGTC	TCCTAGCG
TCCTAGTG	TCCTAGCG
TCCTAGNC	TCCTAGCG
TCCTAGNG	TCCTAGCG
TCAGTCCA	TCGAGTCC
TCAGTCCC	TCGAGTCC
TCAGTCCG	TCGAGTCC
TCAGTCCT	TCGAGTCC
TCAGTCCN	TCGAGTCC
TCCTATCG	TCCTAGCG
TCCAAAAA	TTCCAAAA
TCCTATCT	TCCTCTCT
TCCAAAAC	TTCCAAAA
TCCAAAAG	TTCCAAAA
TCCAAAAT	TTCCAAAA
TCCTATGC	TCCTAGCG
TCCAAAAN	TTCCAAAA
TCAGTCTG	TCGTCTGG
TCCAAAGA	CCAAAGAG
TCGTNTGG	TCGTCTGG
TCCTANCG	TCCTAGCG
TCCAACAA	TCAACAAC
TCATTGGC	TATTGGCG
TCCTANGC	TCCTAGCG
TCATTGTC	CCATTGTC
TCNAACAA	TCAACAAC
TAGATAAT	CAGATAAT
TCCTCACT	TCCTCTCT
TCCTCAGC	TCCTAGCG
TCCAAGCG	TCCTAGCG
TCCTCATC	TCCTCTCT
TCCTCCCT	TCCTCTCT
TAGATCGA	TAAGATCG
TCCTCCTA	TCCTCTCT
TAGATCGC	TAAGATCG
TCCTCCTC	TCCTCTCT
TAGATCGG	TAAGATCG
TCCTCCTG	TCCTCTCT
TAGATCGT	TAAGATCG
TCCTCCTT	TCCTCTCT
TAGATCGN	TAAGATCG
TCCTCCTN	TCCTCTCT
TCCAATTT	CCCAATTT
TCCTCGCG	TCCTAGCG
TCCTCGCT	TCCTCTCT
TCCTCGGC	TCCCGGCT
TCCTCGTC	TCCTCTCT
TCCTCTAC	TCCTCTCT
TCCTCTAT	TCCTCTCT
TCCTCTCA	TCCTCTCT
TCGNAGTC	TCGAGTCC
TAGATTAC	TAATTACA
TCCTCTCC	TCCTCTCT
TCCACAAC	TCAACAAC
TANTAAGG	TATAAGGG
TCCTCTCG	TCCTCTCT
TCCTCTCT	TCCTCTCT
TCCTCTCN	TCCTCTCT
TCCTCTGC	TCCTCTCT
TCCTCTGG	TCGTCTGG
TCCTCTGT	TCCTCTCT
TCCTCTTA	TCCTCTCT
TCCTCTTC	TCCTCTCT
TCCTCTTG	TCCTCTCT
TCCTCTTT	TCCTCTCT
TCCTCTTN	TCCTCTCT
TCCTCTNC	TCCTCTCT
TCCTCTNT	TCCTCTCT
TCNACAAC	TCAACAAC
TCCTCNCT	TCCTCTCT
TCCTCNTC	TCCTCTCT
TCCACCGT	CCCACCGT
TCCTGAGC	TCCTAGCG
TCCACGGC	TCCCGGCT
TCCTGCGA	TCCTAGCG
TCCTGCGC	TCCTAGCG
TCCTGCGG	TCCTAGCG
TCCACTCT	TCCTCTCT
TCCTGCGT	TCCTAGCG
TCCTGCGN	TCCTAGCG
TCCTGCTC	TCCTCTCT
TCCTGGCG	TCCTAGCG
TCCTGGCT	TCCCGGCT
TCATAAGG	TATAAGGG
TCCTGGTA	CCTGGTAC
TCATACAA	TCAACAAC
TCCTGTCT	TCCTCTCT
TCANACAA	TCAACAAC
TCGNCTGG	TCGTCTGG
TCATAGCG	TCCTAGCG
TCCAGCGA	TCCTAGCG
TCCAGCGC	TCCTAGCG
TCCAGCGG	TCCTAGCG
TCCAGCGT	TCCTAGCG
TCCAGCGN	TCCTAGCG
TAGCAAAG	AGCAAAGG
TCCAGGCT	TCCCGGCT
TCCTTAGC	TCCTAGCG
TCCAGTCC	TCGAGTCC
TCNAGTCC	TCGAGTCC
TCCTTCTA	TCCTCTCT
TCCTTCTC	TCCTCTCT
TCCTTCTG	TCCTCTCT
TCCTTCTT	TCCTCTCT
TCCTTCTN	TCCTCTCT
TCCTTGCG	TCCTAGCG
TCCNTAGC	TCCTAGCG
TCANCAAC	TCAACAAC
TGAATTAC	TAATTACA
TCCATAGC	TCCTAGCG
TGAATTCG	GAATTCGT
TCCTTTCT	TCCTCTCT
TCCNTCTC	TCCTCTCT
TCCATCTC	TCCTCTCT
TCGNGTCC	TCGAGTCC
TCCATGTA	TGCCATGT
TCCATGTC	TGCCATGT
TCCATGTG	TGCCATGT
TCCATGTT	TGCCATGT
TCCATGTN	TGCCATGT
TCCATTGT	CCATTGTC
TAGCCAGC	TAACCAGC
TAGCCATG	TGCCATGT
TAGCCCAA	TACGCCCA
TAGCCCAC	TACGCCCA
TAGCCCAG	TACGCCCA
TCCTNAGC	TCCTAGCG
TAGCCCAT	TACGCCCA
TAGCCCAN	TACGCCCA
TCGNTCTG	TCGTCTGG
TGCGAAAT	TGCTAAAT
TCCTNCTC	TCCTCTCT
TCCTNGCG	TCCTAGCG
TGCGAGAC	TGGAGACT
TCCTNTCT	TCCTCTCT
TGCGAGTC	TCGAGTCC
TGCGATGT	TGCCATGT
TGACAGCA	TTGACAGC
TGACAGCC	TTGACAGC
TGACAGCG	TTGACAGC
TGACAGCT	TTGACAGC
TGACAGCN	TTGACAGC
TCCCAAAA	TTCCAAAA
TCCCAATT	CCCAATTT
TGACATGT	TGCCATGT
TGACATTA	GACATTAT
TAGCGCCC	TACGCCCA
TCCCACCG	CCCACCGT
TCGAACAA	TCAACAAC
TGCGCATG	TGCCATGT
TGCGCCCA	TACGCCCA
TCCCAGCG	TCCTAGCG
TCCCAGCT	TCCCGGCT
TCCCAGGC	TCCCGGCT
TGCGCCGG	GCGCCGGG
TAGCGGTA	TACGGTAT
TCCNAGCG	TCCTAGCG
TGACCAGC	TAACCAGC
TCGAAGTC	TCGAGTCC
TGCGCGAA	GCGCGAAG
TGACCATG	TGCCATGT
TCCCATGT	TGCCATGT
TCGAATCC	TCGAGTCC
TAGCGTTC	TTGCGTTC
TGACCCGT	GACCCGTC
TCTAAATA	TGCTAAAT
TCTAAATC	TGCTAAAT
TCTAAATG	TGCTAAAT
TCTAAATT	TGCTAAAT
TCTAAATN	TGCTAAAT
TCTAACAA	TCAACAAC
TAGCTAAA	TGCTAAAT
TCGACAAC	TCAACAAC
TCGACAGC	TTGACAGC
TCTAAGCG	ACTAAGCG
TCTAAGGG	TATAAGGG
TGCGGCAT	TGAGGCAT
TCCCCGCT	TCCCGGCT
TCCCCGGC	TCCCGGCT
TCGACGGA	CCGACGGA
TCCCCTCT	TCCTCTCT
TCGACGTC	TCGAGTCC
TCCNCGGC	TCCCGGCT
TGCGGGGT	TGTGGGGT
TGACGCAT	TGAGGCAT
TGACGCCC	TACGCCCA
TAGCTTCT	AGCTTCTT
TCGACTCC	TCGAGTCC
TCTACAAC	TCAACAAC
TGCGGTAT	TACGGTAT
TCGACTGG	TCGTCTGG
TCGACTTA	ATCGACTT
TCGACTTC	ATCGACTT
TCGACTTG	ATCGACTT
TCGACTTT	ATCGACTT
TCGACTTN	ATCGACTT
TGACGGCA	TGAGGCAT
TCCNCTCT	TCCTCTCT
TGACGGTA	TACGGTAT
TCTGTAGT	CTGTAGTC
TGCGTAAA	TGCTAAAT
TCGAGACC	TCGAGTCC
TCGAGACT	TGGAGACT
TCTGTCCG	TTGTCCGA
TCGAGATC	TCGAGTCC
TCTGTCTG	TCGTCTGG
TCGAGCCA	TCGAGTCC
TCGAGCCC	TCGAGTCC
TCGAGCCG	TCGAGTCC
TCGAGCCT	TCGAGTCC
TCGAGCCN	TCGAGTCC
TCTGTGGA	TTTGTGGA
TGACTAAA	TGCTAAAT
TCGAGCTC	TCGAGTCC
TCTCCAAA	TTCCAAAA
TGCGTCTG	TCGTCTGG
TCGAGGCA	TGAGGCAT
TCGAGGCC	TCGAGTCC
TCTCCATA	CTCTCCAT
TCTCCATC	CTCTCCAT
TCTCCATG	CTCTCCAT
TCTCCATT	CTCTCCAT
TCTCCATN	CTCTCCAT
TCGAGGTC	TCGAGTCC
TGCGTGTT	GCGTGTTA
TCCNGGCT	TCCCGGCT
TCGAGTAC	TCGAGTCC
TCGAGTCA	TCGAGTCC
TCGAGTCC	TCGAGTCC
TCGAGTCG	TCGAGTCC
TGCGTTCA	TTGCGTTC
TCGAGTCT	TCGAGTCC
TGCGTTCC	TTGCGTTC
TCGAGTCN	TCGAGTCC
TGCGTTCG	TTGCGTTC
TGCGTTCT	TTGCGTTC
TCGAGTGC	TCGAGTCC
TGCGTTCN	TTGCGTTC
TCGAGTTC	TCGAGTCC
TCGAGTTT	CGAGTTTA
TCGAGTNC	TCGAGTCC
TCGAGNCC	TCGAGTCC
TCTCCGGC	TCCCGGCT
TCTAGCGA	TCCTAGCG
TCTAGCGC	TCCTAGCG
TCGAGNTC	TCGAGTCC
TCTAGCGG	TCCTAGCG
TCTAGCGT	TCCTAGCG
TCTAGCGN	TCCTAGCG
TCTAGCTC	GCTAGCTC
TCTAGGAC	TTAGGACG
TCGATACG	ACGATACG
TAGGACGA	TTAGGACG
TAGGACGC	TTAGGACG
TAGGACGG	TTAGGACG
TCGATCCA	TCGAGTCC
TAGGACGT	TTAGGACG
TCGATCCC	TCGAGTCC
TAGGACGN	TTAGGACG
TCGATCCG	TCGAGTCC
TCGATCCT	TCGAGTCC
TCGATCCN	TCGAGTCC
TCTAGTCC	TCGAGTCC
TCGATCTG	TCGTCTGG
TAGGAGAC	TGGAGACT
TCGATGTC	TCGAGTCC
TAGGATCG	TAAGATCG
TCGATTCC	TCGAGTCC
TCTATCAC	TTATCACT
TCTTAATG	CTTAATGA
TCTCGGCT	TCCCGGCT
TGCTAAAA	TGCTAAAT
TGCTAAAC	TGCTAAAT
TGCTAAAG	TGCTAAAT
TGCTAAAT	TGCTAAAT
TGCTAAAN	TGCTAAAT
TGCTAACA	TGCTAAAT
TCTTACCG	CTTACCGG
TGCTAACT	TGCTAAAT
TCTATGCA	CTATGCAA
TGCTAAGA	TGCTAAAT
TGCTAAGT	TGCTAAAT
TGCTAATA	TGCTAAAT
TGCTAATC	TGCTAAAT
TGCTAATG	TGCTAAAT
TGCTAATT	TGCTAAAT
TGCTAATN	TGCTAAAT
TGCTAANA	TGCTAAAT
TGCTAANT	TGCTAAAT
TGCTACAA	TGCTAAAT
TGCTACAT	TGCTAAAT
TCTTAGCG	TCCTAGCG
TGCTAGAA	TGCTAAAT
TANTGGCG	TATTGGCG
TGCTAGAT	TGCTAAAT
TGCTAGCG	TCCTAGCG
TGCTAGCT	GCTAGCTC
TGAGACAT	TGAGGCAT
TCGANGTC	TCGAGTCC
TGCTATAA	TGCTAAAT
TGAGACTA	TGGAGACT
TGAGACTC	TGGAGACT
TGAGACTG	TGGAGACT
TGCTATAT	TGCTAAAT
TGAGACTT	TGGAGACT
TGAGACTN	TGGAGACT
TCGANTCC	TCGAGTCC
TCTCTAGC	TCCTAGCG
TGAGAGAC	TGGAGACT
TGCTATGT	TGCCATGT
TGAGAGCA	TGAGGCAT
TGCTANAA	TGCTAAAT
TGCTANAT	TGCTAAAT
TCTCTCCA	CTCTCCAT
TCTCTCTA	TCCTCTCT
TCTCTCTC	TCCTCTCT
TCTCTCTG	TCCTCTCT
TCTCTCTT	TCCTCTCT
TGAGATCG	TAAGATCG
TCTCTCTN	TCCTCTCT
TANTTACA	TAATTACA
TGCTCAAA	TGCTAAAT
TGCTCAAT	TGCTAAAT
TCTCTGGA	TCGTCTGG
TCTCTGGC	TCGTCTGG
TCTCTGGG	TCGTCTGG
TCTCTGGT	TCGTCTGG
TCTCTGGN	TCGTCTGG
TGCTCATG	TGCCATGT
TGGTGACT	TGGAGACT
TCTCTTTA	CTCTTTAA
TCTTCTCT	TCCTCTCT
TANTTGGC	TATTGGCG
TCTTCTGG	TCGTCTGG
TCGCAGTC	TCGAGTCC
TCNCCGGC	TCCCGGCT
TGCTCTCT	TCCTCTCT
TGAGCATA	TGAGGCAT
TGAGCATC	TGAGGCAT
TGAGCATG	TGAGGCAT
TGAGCATT	TGAGGCAT
TGGTGGGG	TGTGGGGT
TGAGCATN	TGAGGCAT
TGGTGGTT	AGGTGGTT
TGAGCCAT	TGAGGCAT
TGCTGAAA	TGCTAAAT
TGCTGAAT	TGCTAAAT
TGAGCGCA	TGAGGCAT
TCTTGGCG	TATTGGCG
TCTTGTGG	TTTGTGGA
TGCTGGGG	TGTGGGGT
TCNCGGCT	TCCCGGCT
TGAGGAAT	TGAGGCAT
TGAGGACA	TGAGGCAT
TGAGGACG	TTAGGACG
TGAGGATA	TGAGGCAT
TGAGGATC	TGAGGCAT
TGAGGATG	TGAGGCAT
TGAGGATT	TGAGGCAT
TGAGGATN	TGAGGCAT
TCTTTAAA	CTCTTTAA
TCTTTAAC	CTCTTTAA
TCTTTAAG	CTCTTTAA
TCTTTAAT	CTCTTTAA
TCTTTAAN	CTCTTTAA
TGAGGCAA	TGAGGCAT
TGAGGCAC	TGAGGCAT
TGAGGCAG	TGAGGCAT
TGAGGCAT	TGAGGCAT
TGAGGCAN	TGAGGCAT
TGAGGCCA	TGAGGCAT
TGAGGCCG	AGAGGCCG
TGAGGCCT	TGAGGCAT
TGAGGCGA	TGAGGCAT
TGAGGCGT	TGAGGCAT
TGAGGCTA	TGAGGCAT
TGAGGCTC	TGAGGCAT
TGGTTTGC	TGTTTTGC
TGAGGCTG	TGAGGCAT
TGAGGCTT	TGAGGCAT
TGAGGCTN	TGAGGCAT
TGAGGCNA	TGAGGCAT
TGGTTTTG	TGTTTTGC
TGAGGCNT	TGAGGCAT
TCTGACAG	TTGACAGC
TGAGGGAT	TGAGGCAT
TGAGGGCA	TGAGGCAT
TGAGGGGT	TGTGGGGT
TCNCTAGC	TCCTAGCG
TGAGGTAT	TGAGGCAT
TGAGGTCA	TGAGGCAT
TCNGTCTG	TCGTCTGG
TCTGAGTC	TCGAGTCC
TCNCTCTC	TCCTCTCT
TGAGGNAT	TGAGGCAT
TCTTTTGC	TGTTTTGC
TGAGGNCA	TGAGGCAT
TGAGTCAT	TGAGGCAT
TGAGTCCA	TCGAGTCC
TGAGTCCC	TCGAGTCC
TGAGTCCG	TCGAGTCC
TGAGTCCT	TCGAGTCC
TGAGTCCN	TCGAGTCC
TGAGTCGG	GAGTCGGT
TGAGTGCA	TGAGGCAT
TGAGTTTA	CGAGTTTA
TCTGCGTT	TTGCGTTC
TGGNAGAC	TGGAGACT
TGAGNCAT	TGAGGCAT
TGAGNGCA	TGAGGCAT
TCNTAGCG	TCCTAGCG
TCTGGGGT	TGTGGGGT
TGATAAAT	TGCTAAAT
TGATAAGG	TATAAGGG
TCTGGTAC	CCTGGTAC
TGATAGAA	GATAGAAA
TGNAGACT	TGGAGACT
TGCAGACT	TGGAGACT
TGGNGACT	TGGAGACT
TCNGAGTC	TCGAGTCC
TGNAGGCA	TGAGGCAT
TGATCACT	TTATCACT
TGCAGGCA	TGAGGCAT
TCNTCTCT	TCCTCTCT
TCNTCTGG	TCGTCTGG
TGCATAAA	TGCTAAAT
TGCATCCA	GCATCCAT
TGATGCAT	TGAGGCAT
TGCATGTA	TGCCATGT
TGCATGTC	TGCCATGT
TGCATGTG	TGCCATGT
TGCATGTT	TGCCATGT
TGCATGTN	TGCCATGT
TGATGGCA	TGAGGCAT
TGATGGGG	TGTGGGGT
TGCTTAAA	TGCTAAAT
TGCTTAAT	TGCTAAAT
TCGCCATG	TGCCATGT
TCGCCCAA	TACGCCCA
TCGCCCAC	TACGCCCA
TCGCCCAG	TACGCCCA
TCGCCCAT	TACGCCCA
TCGCCCAN	TACGCCCA
TCGCCCTA	CCGCCCTA
TGCTTCTT	AGCTTCTT
TGATTACA	TAATTACA
TCGCCGGC	TCCCGGCT
TCGCCGGG	GCGCCGGG
TGCTTTGC	TGTTTTGC
TCGCCTGG	TCGTCTGG
TGCTTTTG	TGTTTTGC
TGATTGGC	TATTGGCG
TGCTNAAA	TGCTAAAT
TCGCGAAG	GCGCGAAG
TGCTNAAT	TGCTAAAT
TGATTTCC	GATTTCCC
TGATTTGC	TGTTTTGC
TGATTTTG	TGTTTTGC
TTACCAAA	TTCCAAAA
TTACCACT	TTATCACT
TTACCAGC	TAACCAGC
TGCCAAAA	TTCCAAAA
TGCCAAAT	TGCTAAAT
TGCCAAGT	TGCCATGT
TGCCAATG	TGCCATGT
TCGCGGCT	TCCCGGCT
TGTAAATA	TGCTAAAT
TGTAAATC	TGCTAAAT
TGTAAATG	TGCTAAAT
TGCCACGT	TGCCATGT
TTACCGAA	GTACCGAA
TGTAAATT	TGCTAAAT
TGTAAATN	TGCTAAAT
TGCCACTG	TGCCATGT
TTACCGGA	CTTACCGG
TTACCGGC	CTTACCGG
TTACCGGG	CTTACCGG
TTACCGGT	CTTACCGG
TGANGCAT	TGAGGCAT
TTACCGGN	CTTACCGG
TCGCGTCC	TCGAGTCC
TGNCATGT	TGCCATGT
TGCCAGGT	TGCCATGT
TCGCGTTC	TTGCGTTC
TGCCAGTA	TGCCATGT
TGCCAGTC	TGCCATGT
TGCCAGTG	TGCCATGT
TGCCAGTT	TGCCATGT
TGCCAGTN	TGCCATGT
TGCCATAG	TGCCATGT
TGCCATAT	TGCCATGT
TGCCATCG	TGCCATGT
TGTAAGGG	TATAAGGG
TGCCATCT	TGCCATGT
TGANGGCA	TGAGGCAT
TGCCATGA	TGCCATGT
TGCCATGC	TGCCATGT
TGCCATGG	TGCCATGT
TGCCATGT	TGCCATGT
TGCCATGN	TGCCATGT
TGCCATTA	TGCCATGT
TGCCATTC	TGCCATGT
TGCCATTG	TGCCATGT
TGCCATTT	TGCCATGT
TGCCATTN	TGCCATGT
TGCCATNG	TGCCATGT
TGCCATNT	TGCCATGT
TCGCTAAA	TGCTAAAT
TGCNAAAT	TGCTAAAT
TGGACACT	TGGAGACT
TCGCTAGC	TCCTAGCG
TGGACAGC	TTGACAGC
TGCCANGT	TGCCATGT
TGNCCATG	TGCCATGT
TGCCANTG	TGCCATGT
TTACGACG	TTAGGACG
TCGCTCTC	TCCTCTCT
TCGCTCTG	TCGTCTGG
TGCCCATG	TGCCATGT
TTACGCCC	TACGCCCA
TGGACGAC	TGGAGACT
TCGCTGGA	TCGTCTGG
TCGCTGGC	TCGTCTGG
TCGCTGGG	TCGTCTGG
TCGCTGGT	TCGTCTGG
TCGCTGGN	TCGTCTGG
TTACGGAC	TTAGGACG
TTACGGTA	TACGGTAT
TGTACCGA	GTACCGAA
TGCCCGGC	TCCCGGCT
TTACGTTC	TTGCGTTC
TGCNATGT	TGCCATGT
TGCCCTGT	TGCCATGT
TGGAGAAC	TGGAGACT
TGGAGAAT	TGGAGACT
TGGAGACA	TGGAGACT
TGGAGACC	TGGAGACT
TGGAGACG	TGGAGACT
TGGAGACT	TGGAGACT
TGGAGACN	TGGAGACT
TGGAGAGC	TGGAGACT
TGGAGAGT	TGGAGACT
TGGAGATA	TGGAGACT
TGGAGATC	TGGAGACT
TGGAGATG	TGGAGACT
TGGAGATT	TGGAGACT
TGGAGATN	TGGAGACT
TGGAGANC	TGGAGACT
TGGAGANT	TGGAGACT
TGGAGCAC	TGGAGACT
TTCGTCCG	TTGTCCGA
TGGAGCCT	TGGAGACT
TTACTCAC	TTATCACT
TGCNCATG	TGCCATGT
TTCGTCTG	TCGTCTGG
TGCCGATG	TGCCATGT
TGGAGCTA	TGGAGACT
TGGAGCTC	TGGAGACT
TGGAGCTG	TGGAGACT
TGGAGCTT	TGGAGACT
TGGAGCTN	TGGAGACT
TGTAGACT	TGGAGACT
TGGAGGAC	TGGAGACT
TGGAGGCA	TGAGGCAT
TTCGTGGA	TTTGTGGA
TGGAGGCT	TGGAGACT
TTCGTTCA	TTGCGTTC
TTCGTTCC	TTGCGTTC
TGGAGTAC	TGGAGACT
TTCGTTCG	TTGCGTTC
TTCGTTCT	TTGCGTTC
TGCCGGCT	TCCCGGCT
TTCGTTCN	TTGCGTTC
TGGAGTCC	TCGAGTCC
TGGAGTCT	TGGAGACT
TGTAGGAC	TTAGGACG
TGTAGGCA	TGAGGCAT
TGGAGNAC	TGGAGACT
TGTAGGGG	TGTGGGGT
TGTAGGGT	TGTGGGGT
TGCCGTGT	TGCCATGT
TGGAGNCT	TGGAGACT
TCGGAAAA	ATCGGAAA
TCGGAAAC	ATCGGAAA
TCGGAAAG	ATCGGAAA
TCGGAAAT	ATCGGAAA
TCGGAAAN	ATCGGAAA
TGTAGTCA	CTGTAGTC
TGTAGTCC	CTGTAGTC
TGTAGTCG	CTGTAGTC
TGTAGTCT	CTGTAGTC
TGTAGTCN	CTGTAGTC
TGGATACT	TGGAGACT
TGCCTAAA	TGCTAAAT
TGCCTAAT	GCCTAATA
TGCCTAGC	TCCTAGCG
TCGGAGAC	TGGAGACT
TGCCTATG	TGCCATGT
TCGGAGTC	TCGAGTCC
TGGATGAC	TGGAGACT
TGCCTCTC	TCCTCTCT
TGTATCAC	TTATCACT
TGCCTGTA	TGCCATGT
TGCCTGTC	TGCCATGT
TGCCTGTG	TGCCATGT
TGCCTGTT	TGCCATGT
TGCCTGTN	TGCCATGT
TGCAAAAT	TGCTAAAT
TGCAAAGG	AGCAAAGG
TGCAAATA	TGCTAAAT
TGCAAATC	TGCTAAAT
TGCAAATG	TGCTAAAT
TGCCTTGT	TGCCATGT
TGCAAATT	TGCTAAAT
TGCAAATN	TGCTAAAT
TTCTAAAA	TTCCAAAA
TGCAACAA	TCAACAAC
TTCTAAAT	TGCTAAAT
TGTATTGC	TGTTTTGC
TGGANACT	TGGAGACT
TGTATTTG	TGTTTTGC
TTAGAACG	TTAGGACG
TTAGACAG	TTGACAGC
TGCNTAAA	TGCTAAAT
TTAGACGA	TTAGGACG
TTAGACGC	TTAGGACG
TGCCNATG	TGCCATGT
TTAGACGG	TTAGGACG
TTAGACGT	TTAGGACG
TTAGACGN	TTAGGACG
TTCTAGCG	TCCTAGCG
TGGANGAC	TGGAGACT
TTAGAGAC	TTAGGACG
TGCAATGT	TGCCATGT
TCGGCTGG	TCGTCTGG
TTAGATCG	TAAGATCG
TGCCNTGT	TGCCATGT
TCGGGAAC	CGGGAACC
TTCTCAAA	TTCCAAAA
TGCACATG	TGCCATGT
TTCTCACT	TTATCACT
TTAGCACG	TTAGGACG
TTAGCACT	TTATCACT
TTCTCCAT	CTCTCCAT
TCGGGCGT	CCGGGCGT
TTCTCCGA	TTGTCCGA
TGGCACCA	GTGGCACC
TGGCACCC	GTGGCACC
TGGCACCG	GTGGCACC
TGGCACCT	GTGGCACC
TGGCACCN	GTGGCACC
TGTCAAAT	GTCAAATG
TTAGCGAC	TTAGGACG
TGGCAGAC	TGGAGACT
TCGGGTAG	CGGGTAGG
TCGGGTCC	TCGAGTCC
TTAGCGTT	TTGCGTTC
TTCTCTCT	TCCTCTCT
TGGCATGT	TGCCATGT
TGTCAGGC	GTCAGGCT
TGTTCTGC	TGTTTTGC
TGTTCTTG	TGTTTTGC
TGTCTAAA	TGCTAAAT
TCGGTATA	TACGGTAT
TCGGTATC	TACGGTAT
TCGGTATG	TACGGTAT
TTAGGAAC	TTAGGACG
TCGGTATT	TACGGTAT
TTAGGAAG	TTAGGACG
TCGGTATN	TACGGTAT
TGTCATGT	TGCCATGT
TTAGGACA	TTAGGACG
TTAGGACC	TTAGGACG
TTAGGACG	TTAGGACG
TTAGGACT	TTAGGACG
TTAGGACN	TTAGGACG
TTAGGAGA	TTAGGACG
TTAGGAGC	TTAGGACG
TTAGGAGG	TTAGGACG
TTAGGAGT	TTAGGACG
TCGGTCCA	TCGAGTCC
TTAGGAGN	TTAGGACG
TCGGTCCC	TCGAGTCC
TCGGTCCG	TCGAGTCC
TTAGGATC	TTAGGACG
TCGGTCCT	TCGAGTCC
TTAGGATG	TTAGGACG
TCGGTCCN	TCGAGTCC
TGGCCATG	TGCCATGT
TTAGGANC	TTAGGACG
TTAGGANG	TTAGGACG
TCGGTCTG	TCGTCTGG
TTAGGCAC	TTAGGACG
TGTCTCAG	AGTCTCAG
TTAGGCAT	TGAGGCAT
TTAGGCCG	TTAGGACG
TTAGGCGA	TTAGGACG
TTAGGCGC	TTAGGACG
TTAGGCGG	TTAGGACG
TTAGGCGT	TTAGGACG
TTAGGCGN	TTAGGACG
TGTCCAAA	TTCCAAAA
TTAGGGAC	TTAGGACG
TTAGGGCG	TTAGGACG
TGTCCATG	TGCCATGT
TGGAAACT	TGGAGACT
TGTCTGGA	TCGTCTGG
TGTCTGGC	TCGTCTGG
TGTCTGGG	TCGTCTGG
TGTCTGGT	TCGTCTGG
TGTCTGGN	TCGTCTGG
TGTTGGCG	TATTGGCG
TTAGGTAC	TTAGGACG
TTCTGTGG	TTTGTGGA
TGTTGGGG	TGTGGGGT
TGTTGGGT	TGTGGGGT
TTAGGTCG	TTAGGACG
TGGAACTA	TGGAGACT
TGTCCGAA	TTGTCCGA
TGGAACTC	TGGAGACT
TGTCCGAC	TTGTCCGA
TGTCTTGC	TGTTTTGC
TGGAACTG	TGGAGACT
TGTCCGAG	TTGTCCGA
TGGAACTT	TGGAGACT
TGTCCGAT	TTGTCCGA
TGGAACTN	TGGAGACT
TGTCCGAN	TTGTCCGA
TGTCTTTG	TGTTTTGC
TTAGGNAC	TTAGGACG
TGTTGTGC	TGTTTTGC
TGTTGTGG	TTTGTGGA
TTAGGNCG	TTAGGACG
TGTTGTTG	TGTTTTGC
TGGAAGAC	TGGAGACT
TTAGTACG	TTAGGACG
TGGCGACT	TGGAGACT
TGTTTAAA	GTTTAAAG
TTAGTCAC	TTATCACT
TGTTTAGC	TGTTTTGC
TTAGTCCG	TTGTCCGA
TGTTTATG	TGTTTTGC
TTAGTGAC	TTAGGACG
TGTTTCGC	TGTTTTGC
TGTTTCTG	TGTTTTGC
TTAGTGGA	TTTGTGGA
TTCTTTAA	CTCTTTAA
TGTTTGAC	GTTTGACT
TGTTTGCA	TGTTTTGC
TGTTTGCC	TGTTTTGC
TGTTTGCG	TGTTTTGC
TGTTTGCT	TGTTTTGC
TGTTTGCN	TGTTTTGC
TGTTTGGC	TGTTTTGC
TGTTTGTG	TGTTTTGC
TGTTTTAC	TGTTTTGC
TGTTTTAG	TGTTTTGC
TGGCGTTC	TTGCGTTC
TGTTTTCA	TGTTTTGC
TGTTTTCC	TGTTTTGC
TGTTTTCG	TGTTTTGC
TGTTTTCT	TGTTTTGC
TGTTTTCN	TGTTTTGC
TGTTTTGA	TGTTTTGC
TGTTTTGC	TGTTTTGC
TGTTTTGG	TGTTTTGC
TGTCGGGG	TGTGGGGT
TGTTTTGT	TGTTTTGC
TGTCGGGT	TGTGGGGT
TGTTTTGN	TGTTTTGC
TGTTTTTC	TGTTTTGC
TGTTTTTG	TGTTTTGC
TGTTTTNC	TGTTTTGC
TGTTTTNG	TGTTTTGC
TGTTTNGC	TGTTTTGC
TGGCTAAA	TGCTAAAT
TGTTTNTG	TGTTTTGC
TTGNACAG	TTGACAGC
TTAGNACG	TTAGGACG
TGTGACAG	TTGACAGC
TGGCTTAA	AGGCTTAA
TGTGAGAC	TGGAGACT
TTAGNGAC	TTAGGACG
TGTGAGGG	TGTGGGGT
TGTGAGGT	TGTGGGGT
TGTTNTGC	TGTTTTGC
TGTTNTTG	TGTTTTGC
TTCNAAAA	TTCCAAAA
TGNTAAAT	TGCTAAAT
TTGNCAGC	TTGACAGC
TTGNCCGA	TTGTCCGA
TTATAACT	TTATCACT
TTATAAGG	TATAAGGG
TGNCTAAA	TGCTAAAT
TTGNCGTT	TTGCGTTC
TTATACAC	TTATCACT
TTATACTA	TTATCACT
TTATACTC	TTATCACT
TTATACTG	TTATCACT
TTATACTT	TTATCACT
TTATACTN	TTATCACT
TGTGCGGG	TGTGGGGT
TGTGCGGT	TGTGGGGT
TGTGCGTT	TTGCGTTC
TTATATCA	ATTATATC
TTATATCC	ATTATATC
TTATATCG	ATTATATC
TTATATCT	ATTATATC
TTATATCN	ATTATATC
TTATCAAC	TTATCACT
TTATCAAT	TTATCACT
TTATCACA	TTATCACT
TTATCACC	TTATCACT
TTATCACG	TTATCACT
TTATCACT	TTATCACT
TTATCACN	TTATCACT
TTATCAGC	TTATCACT
TTNAGGAC	TTAGGACG
TTATCAGT	TTATCACT
TTATCATA	TTATCACT
TTATCATC	TTATCACT
TTATCATG	TTATCACT
TTATCATT	TTATCACT
TTATCATN	TTATCACT
TTATCANC	TTATCACT
TTATCANT	TTATCACT
TGTGGAGG	TGTGGGGT
TTATCCAC	TTATCACT
TGTGGAGT	TGTGGGGT
TTATCCCT	TTATCACT
TTATCCGA	TTGTCCGA
TTATCCTA	TTATCACT
TTATCCTC	TTATCACT
TGTGGCAC	GTGGCACC
TTATCCTG	TTATCACT
TTATCCTT	TTATCACT
TGTGGCAT	TGAGGCAT
TTATCCTN	TTATCACT
TTGNGTTC	TTGCGTTC
TTATCGAC	TTATCACT
TGTGGCGG	TGTGGGGT
TGTGGCGT	TGTGGGGT
TTATCGCT	TTATCACT
TGTGGGAG	TGTGGGGT
TGTGGGAT	TGTGGGGT
TGTGGGCG	TGTGGGGT
TTATCTAC	TTATCACT
TGTGGGCT	TGTGGGGT
TGTGGGGA	TGTGGGGT
TGTGGGGC	TGTGGGGT
TGTGGGGG	TGTGGGGT
TGTGGGGT	TGTGGGGT
TTATCTCT	TTATCACT
TGTGGGGN	TGTGGGGT
TGTGGGTA	TGTGGGGT
TGTGGGTC	TGTGGGGT
TGTGGGTG	TGTGGGGT
TGTGGGTT	TGTGGGGT
TGTGGGTN	TGTGGGGT
TGTGGGNG	TGTGGGGT
TGTGGGNT	TGTGGGGT
TTATCNAC	TTATCACT
TTATCNCT	TTATCACT
TGTGGTGG	TGTGGGGT
TTGNTCCG	TTGTCCGA
TGTGGTGT	TGTGGGGT
TTNATCAC	TTATCACT
TTATGACG	TTAGGACG
TTATGACT	TTATCACT
TGTGGNGG	TGTGGGGT
TGTGGNGT	TGTGGGGT
TTATGCAA	CTATGCAA
TTATGCAC	TTATCACT
TGNTGGGG	TGTGGGGT
TGTNGGGG	TGTGGGGT
TGTNGGGT	TGTGGGGT
TTATGGAC	TTAGGACG
TGTGTCCG	TTGTCCGA
TGAAAATT	GAAAATTT
TTATGTGG	TTTGTGGA
TGTGTGGA	TTTGTGGA
TGTGTGGG	TGTGGGGT
TGTGTGGT	TGTGGGGT
TGTGTTGC	TGTTTTGC
TGTGTTTG	TGTTTTGC
TTATTACA	TAATTACA
TGNGAGAC	TGGAGACT
TTATTACT	TTATCACT
TTATTCAC	TTATCACT
TGAACAAC	TCAACAAC
TGNTTTGC	TGTTTTGC
TGTNTTGC	TGTTTTGC
TGNTTTTG	TGTTTTGC
TTATTGGC	TATTGGCG
TGTNTTTG	TGTTTTGC
TGAACCAG	TAACCAGC
TTTAAAGA	GTTTAAAG
TTTAAAGC	GTTTAAAG
TTNCAAAA	TTCCAAAA
TTTAAAGG	GTTTAAAG
TTTAAAGT	GTTTAAAG
TTTAAAGN	GTTTAAAG
TTCCAAAA	TTCCAAAA
TTCCAAAC	TTCCAAAA
TTCCAAAG	TTCCAAAA
TTCCAAAT	TTCCAAAA
TTCCAAAN	TTCCAAAA
TTCCAACA	TTCCAAAA
TTCCAAGA	TTCCAAAA
TTCCAATA	TTCCAAAA
TTCCAANA	TTCCAAAA
TGTGNGGG	TGTGGGGT
TGTGNGGT	TGTGGGGT
TTCCACAA	TTCCAAAA
TTATNACT	TTATCACT
TTTAAGGG	TATAAGGG
TTCCAGAA	TTCCAAAA
TTATNCAC	TTATCACT
TTTAATGA	CTTAATGA
TTCCATAA	TTCCAAAA
TGAAGACT	TGGAGACT
TTCCATGT	TGCCATGT
TGTTAAAT	TGCTAAAT
TGAAGATC	TAAGATCG
TTCCANAA	TTCCAAAA
TGAAGCAT	TGAGGCAT
TTTACAGC	TTGACAGC
TTNCCAAA	TTCCAAAA
TTCCCAAA	TTCCAAAA
TGAAGGCA	TGAGGCAT
TGNGGCAT	TGAGGCAT
TTTACCGG	CTTACCGG
TGAAGGGT	GAAGGGTA
TGNGGGGT	TGTGGGGT
TTCCCGGC	TCCCGGCT
TGTTATGC	TGTTTTGC
TGTTATTG	TGTTTTGC
TTANGACG	TTAGGACG
TTCCGAAA	TTCCAAAA
TTCCGCCA	ATCCGCCA
TTTAGGAC	TTAGGACG
TTANGGAC	TTAGGACG
TTANCACT	TTATCACT
TTCCGGCT	TCCCGGCT
TTTAGTGG	TTTGTGGA
TTNCGTTC	TTGCGTTC
TGGGAACC	CGGGAACC
TTCCGTTC	TTGCGTTC
TGGGACTA	TGGAGACT
TGGGACTC	TGGAGACT
TGGGACTG	TGGAGACT
TGGGACTT	TGGAGACT
TTCCTAAA	TTCCAAAA
TGGGACTN	TGGAGACT
TGGGAGAC	TGGAGACT
TTCCTAGC	TCCTAGCG
TTANTCAC	TTATCACT
TTCCTCTC	TCCTCTCT
TTTATATC	ATTATATC
TTCCTGAA	ATTCCTGA
TTCCTGAC	ATTCCTGA
TTCCTGAG	ATTCCTGA
TTCCTGAT	ATTCCTGA
TTCCTGAN	ATTCCTGA
TTTATCAC	TTATCACT
TTTATGGA	TTTGTGGA
TGGGCATA	TGAGGCAT
TGGGCATC	TGAGGCAT
TGGGCATG	TGAGGCAT
TGGGCATT	TGAGGCAT
TGGGCATN	TGAGGCAT
TTCNCAAA	TTCCAAAA
TTCCNAAA	TTCCAAAA
TTGANAGC	TTGACAGC
TTGANCAG	TTGACAGC
TGGGCTAA	ATGGGCTA
TGGGCTAC	ATGGGCTA
TGGGCTAG	ATGGGCTA
TGGGCTAT	ATGGGCTA
TGGGCTAN	ATGGGCTA
TNAGATCG	TAAGATCG
TGGGGACT	TGGAGACT
TGGGGCAT	TGAGGCAT
TTGCAAAA	TTCCAAAA
TTCGAAAA	TTCCAAAA
TTCAAAAA	TTCCAAAA
TTTCAAAA	TTCCAAAA
TTCAAAAC	TTCCAAAA
TTCAAAAG	TTCCAAAA
TTCAAAAT	TTCCAAAA
TTCAAAAN	TTCCAAAA
TGGGGGGT	TGTGGGGT
TTTCAACC	ATTCAACC
TTGCACAG	TTGACAGC
TGGGGGTA	TGTGGGGT
TGGGGGTC	TGTGGGGT
TGGGGGTG	TGTGGGGT
TGGGGGTT	TGTGGGGT
TGGGGGTN	TGTGGGGT
TTCAAATG	GTCAAATG
TTCGACAG	TTGACAGC
TTCAACAA	TCAACAAC
TTCAACCA	ATTCAACC
TTCAACCC	ATTCAACC
TTGCAGCA	TTGACAGC
TTGCAGCC	TTGACAGC
TTCAACCG	ATTCAACC
TTGCAGCG	TTGACAGC
TTCAACCT	ATTCAACC
TTGCAGCT	TTGACAGC
TTTCACTA	TTATCACT
TTCAACCN	ATTCAACC
TTGCAGCN	TTGACAGC
TTTCACTC	TTATCACT
TTTCACTG	TTATCACT
TTTCACTT	TTATCACT
TTTCACTN	TTATCACT
TNCTCTCT	TCCTCTCT
TTCGACTT	ATCGACTT
TTGCAGTT	TTGCGTTC
TTCGAGTC	TCGAGTCC
TTGCATTC	TTGCGTTC
TGGGTAGG	CGGGTAGG
TNAGGACG	TTAGGACG
TNAGGCAT	TGAGGCAT
TTGCCAAA	TTCCAAAA
TTGCCAGC	TTGACAGC
TTTCCAAA	TTCCAAAA
TTGCCATG	TGCCATGT
TTCGCAAA	TTCCAAAA
TTGCCCGA	TTGTCCGA
TTCACAAA	TTCCAAAA
TTCACAGC	TTGACAGC
TTGCCGAA	TTGTCCGA
TTGCCGAC	TTGTCCGA
TTGCCGAG	TTGTCCGA
TTGCCGAT	TTGTCCGA
TTGCCGAN	TTGTCCGA
TTTCCGAA	TTGTCCGA
TTTCCGAC	TTGTCCGA
TTTCCGAG	TTGTCCGA
TTTCCGAT	TTGTCCGA
TTTCCGAN	TTGTCCGA
TTGCCGTT	TTGCGTTC
TTCGCCCA	TACGCCCA
TTGCCTTC	TTGCGTTC
TTTCCTGA	ATTCCTGA
TTCGCGTT	TTGCGTTC
TTGCGATC	TTGCGTTC
TTGCGATT	TTGCGTTC
TTGCGCTC	TTGCGTTC
TTGCGCTT	TTGCGTTC
TTCGGAAA	ATCGGAAA
TTCGGACG	TTAGGACG
TTGCGGTC	TTGCGTTC
TTGCGGTT	TTGCGTTC
TTGCGTAC	TTGCGTTC
TTGCGTAT	TTGCGTTC
TTGCGTCA	TTGCGTTC
TTGCGTCC	TTGCGTTC
TTGCGTCG	TTGCGTTC
TTGCGTCT	TTGCGTTC
TTGCGTCN	TTGCGTTC
TTGCGTGC	TTGCGTTC
TTGCGTGT	TTGCGTTC
TGGTAAAT	TGCTAAAT
TTGCGTTA	TTGCGTTC
TTGCGTTC	TTGCGTTC
TTGCGTTG	TTGCGTTC
TTTCGTGG	TTTGTGGA
TTGCGTTT	TTGCGTTC
TTGCGTTN	TTGCGTTC
TTGCGTNC	TTGCGTTC
TTTCGTTC	TTGCGTTC
TTGCGTNT	TTGCGTTC
TTCAGGAC	TTAGGACG
TTCAGGCT	GTCAGGCT
TTGCGNTC	TTGCGTTC
TTGCGNTT	TTGCGTTC
TTGCTAAA	TGCTAAAT
TTCGGTAT	TACGGTAT
TGGTAGAC	TGGAGACT
TTGCTCCG	TTGTCCGA
TTTCTGGA	TTTGTGGA
TTGCTGTT	TTGCGTTC
TTGCTTCA	TTGCGTTC
TTGCTTCC	TTGCGTTC
TTGCTTCG	TTGCGTTC
TTGCTTCT	TTGCGTTC
TTGCTTCN	TTGCGTTC
TTGCTTTC	TTGCGTTC
TTCATCAC	TTATCACT
TTGAAAGC	TTGACAGC
TNATAAGG	TATAAGGG
TTGAACAG	TTGACAGC
TGGTCCGA	TTGTCCGA
TTGAAGCA	TTGACAGC
TTGAAGCC	TTGACAGC
TTGAAGCG	TTGACAGC
TTGAAGCT	TTGACAGC
TTGAAGCN	TTGACAGC
TGGTCTGG	TCGTCTGG
TTGCNGTT	TTGCGTTC
TTGACAAC	TTGACAGC
TTGACAAG	TTGACAGC
TTGACACA	TTGACAGC
TTGACACC	TTGACAGC
TTGACACG	TTGACAGC
TTGCNTTC	TTGCGTTC
TTGACACT	TTGACAGC
TTGACACN	TTGACAGC
TTGACAGA	TTGACAGC
TNATCACT	TTATCACT
TTGACAGC	TTGACAGC
TTGACAGG	TTGACAGC
TTGACAGT	TTGACAGC
TTGACAGN	TTGACAGC
TTGACATC	TTGACAGC
TTGACATG	TTGACAGC
TTGACANC	TTGACAGC
TTGACANG	TTGACAGC
TTGACCAG	TTGACAGC
TTGACCGA	TTGTCCGA
TTGACCGC	TTGACAGC
TTGACGAG	TTGACAGC
TTGACGCA	TTGACAGC
TTGACGCC	TTGACAGC
TTGACGCG	TTGACAGC
TTGACGCT	TTGACAGC
TTGACGCN	TTGACAGC
TTGACGGC	TTGACAGC
TTGACGTT	TTGCGTTC
TTGGACAG	TTGACAGC
TTTGACAG	TTGACAGC
TTGGACGA	TTAGGACG
TTGACTAG	TTGACAGC
TTGGACGC	TTAGGACG
TTGGACGG	TTAGGACG
TTGGACGT	TTAGGACG
TTGGACGN	TTAGGACG
TTTGACTA	GTTTGACT
TTTGACTC	GTTTGACT
TTTGACTG	GTTTGACT
TTTGACTT	GTTTGACT
TTGACTGC	TTGACAGC
TTTGACTN	GTTTGACT
TTGGAGAC	TGGAGACT
TTGACNAG	TTGACAGC
TTTGAGGA	TTTGTGGA
TTGACNGC	TTGACAGC
TTTGATGG	TTTGTGGA
TTGAGACT	TGGAGACT
TTGAGAGC	TTGACAGC
TTGAGCAG	TTGACAGC
TTGGCACC	GTGGCACC
TTGAGGAC	TTAGGACG
TTGGCAGC	TTGACAGC
TTGAGGCA	TGAGGCAT
TTTGCGGA	TTTGTGGA
TTGGCCGA	TTGTCCGA
TTTGCGTT	TTGCGTTC
TTGAGTCC	TCGAGTCC
TTGAGTTC	TTGCGTTC
TTTGCTGG	TTTGTGGA
TTGGCGTT	TTGCGTTC
TTGATAGC	TTGACAGC
TTTGGACG	TTAGGACG
TTGATCAC	TTATCACT
TTGATCAG	TTGACAGC
TTGATCCG	TTGTCCGA
TNATTACA	TAATTACA
TTTNGTGG	TTTGTGGA
TTTGGCGA	TATTGGCG
TTTGGCGC	TATTGGCG
TTTGGCGG	TATTGGCG
TTTGGCGT	TATTGGCG
TTTGGCGN	TATTGGCG
TTTGGGAA	TTTGTGGA
TTTGGGAC	TTTGTGGA
TTTGGGAG	TTTGTGGA
TTTGGGAT	TTTGTGGA
TTTGGGAN	TTTGTGGA
TTTGGGGA	TTTGTGGA
TTTGGGGT	TGTGGGGT
TNATTGGC	TATTGGCG
TTTGGTGG	TTTGTGGA
TTAACAAC	TCAACAAC
TTAACACT	TTATCACT
TTAACAGC	TTGACAGC
TTTNTGGA	TTTGTGGA
TTNGACAG	TTGACAGC
TTTGTAGA	TTTGTGGA
TTTGTAGG	TTTGTGGA
TTAACCAG	TAACCAGC
TNTAAGGG	TATAAGGG
TTTGTCCG	TTGTCCGA
TTTGTCGA	TTTGTGGA
TTTGTCGG	TTTGTGGA
TTTGTGAA	TTTGTGGA
TTTGTGAC	TTTGTGGA
TTTGTGAG	TTTGTGGA
TTTGTGAT	TTTGTGGA
TTTGTGAN	TTTGTGGA
TTTGTGCA	TTTGTGGA
TTTGTGCG	TTTGTGGA
TTTGTGGA	TTTGTGGA
TTTGTGGC	TTTGTGGA
TTTGTGGG	TTTGTGGA
TTTGTGGT	TTTGTGGA
TTTGTGGN	TTTGTGGA
TTTGTGTA	TTTGTGGA
TTTGTGTG	TTTGTGGA
TTTGTGNA	TTTGTGGA
TTTGTGNG	TTTGTGGA
TTTGTTGA	TTTGTGGA
TTTGTTGG	TTTGTGGA
TTTGTNGA	TTTGTGGA
TTTGTNGG	TTTGTGGA
TTAAGACG	TTAGGACG
TTNGCGTT	TTGCGTTC
TTAAGATC	TAAGATCG
TTTGNGGA	TTTGTGGA
TTNGGACG	TTAGGACG
TTAAGGAC	TTAGGACG
TTAAGGGA	TATAAGGG
TTAAGGGC	TATAAGGG
TTAAGGGG	TATAAGGG
TTAAGGGT	TATAAGGG
TTAAGGGN	TATAAGGG
TTTGNTGG	TTTGTGGA
TNTAGGAC	TTAGGACG
TTTTAAAG	GTTTAAAG
TTNACAGC	TTGACAGC
TTAATCAC	TTATCACT
TTNGTCCG	TTGTCCGA
TTAATGAA	CTTAATGA
TTAATGAC	CTTAATGA
TTAATGAG	CTTAATGA
TTAATGAT	CTTAATGA
TTAATGAN	CTTAATGA
TNTATCAC	TTATCACT
TTNGTGGA	TTTGTGGA
TTAATTAC	TAATTACA
TTTTCACT	TTATCACT
TNCCTAGC	TCCTAGCG
TTTTCCGA	TTGTCCGA
TNCCTCTC	TCCTCTCT
TTTTGACT	GTTTGACT
TTTTGGAA	TTTGTGGA
TTTTGGAC	TTTGTGGA
TTTTGGAG	TTTGTGGA
TTTTGGAT	TTTGTGGA
TTTTGGAN	TTTGTGGA
TTTTGGCG	TATTGGCG
TTTTGTGG	TTTGTGGA
TTNTCACT	TTATCACT
TTACAAAA	TTCCAAAA
TTNTCCGA	TTGTCCGA
TTACACTA	TTATCACT
TTACACTC	TTATCACT
TTACACTG	TTATCACT
TTACACTT	TTATCACT
TTACACTN	TTATCACT
TTACAGCA	TTGACAGC
TTACAGCC	TTGACAGC
TTACAGCG	TTGACAGC
TNCGAGTC	TCGAGTCC
TTACAGCT	TTGACAGC
TTACAGCN	TTGACAGC
TTTTTGCA	TGTTTTGC
TTTTTGCC	TGTTTTGC
TTTTTGCG	TGTTTTGC
TTTTTGCT	TGTTTTGC
TTTTTGCN	TGTTTTGC
TTTTTGGA	TTTGTGGA
TNTCCAAA	TTCCAAAA
NAAGGGTA	GAAGGGTA
TTTTTTGC	TGTTTTGC
NAAGGTCC	CAAGGTCC
TTGGGACG	TTAGGACG
TNCGCCCA	TACGCCCA
TTGGGCTA	ATGGGCTA
TNCAACAA	TCAACAAC
TTNTGTGG	TTTGTGGA
TTGGGGTA	TGTGGGGT
TTGGGGTC	TGTGGGGT
TTGGGGTG	TGTGGGGT
TTGGGGTT	TGTGGGGT
TTGGGGTN	TGTGGGGT
TTGGGTTC	TTGCGTTC
NAAGTTGC	AAGTTGCG
TTGGTCCG	TTGTCCGA
TNGCGTTC	TTGCGTTC
TNCGGTAT	TACGGTAT
TTGGTGGA	TTTGTGGA
TNGCTAAA	TGCTAAAT
TTGGTTCA	TTGCGTTC
TTGGTTCC	TTGCGTTC
TTGGTTCG	TTGCGTTC
TTGGTTCT	TTGCGTTC
TTGGTTCN	TTGCGTTC
TNCGTCTG	TCGTCTGG
NAATAGCT	AATAGCTT
TTGTACAG	TTGACAGC
TTGTACCG	TTGTCCGA
TTGTACGA	TTGTCCGA
TNGACAGC	TTGACAGC
TTGTAGTC	CTGTAGTC
TNTGACAG	TTGACAGC
TNCTAAAT	TGCTAAAT
TNGGAGAC	TGGAGACT
NAATGACC	AATGACCG
TTGTCACG	TTGTCCGA
TTGTCACT	TTATCACT
TNCTAGCG	TCCTAGCG
TTGTCAGA	TTGTCCGA
TTGTCAGC	TTGACAGC
TTGTCCAA	TTGTCCGA
TTGTCCAC	TTGTCCGA
TTGTCCAG	TTGTCCGA
TTGTCCAT	TTGTCCGA
TTGTCCAN	TTGTCCGA
TTGTCCCA	TTGTCCGA
TTGTCCCG	TTGTCCGA
TTGTCCGA	TTGTCCGA
TTGTCCGC	TTGTCCGA
TTGTCCGG	TTGTCCGA
TTGTCCGT	TTGTCCGA
TTGTCCGN	TTGTCCGA
TNGAGACT	TGGAGACT
TTGTCCTA	TTGTCCGA
TTGTCCTG	TTGTCCGA
TTGTCCNA	TTGTCCGA
TTGTCCNG	TTGTCCGA
TTGTCGAA	TTGTCCGA
TTGTCGAC	TTGTCCGA
TTGTCGAG	TTGTCCGA
TTGTCGAT	TTGTCCGA
TTGTCGAN	TTGTCCGA
NAATGTAG	AAATGTAG
TTGTCGCG	TTGTCCGA
TTGTCGGA	TTGTCCGA
TTGTCGTT	TTGCGTTC
TNGAGGCA	TGAGGCAT
TTGTCTCG	TTGTCCGA
TTGTCTGA	TTGTCCGA
TTGTCTGG	TCGTCTGG
TNCCAAAA	TTCCAAAA
TNTGCGTT	TTGCGTTC
NAATTACA	TAATTACA
TNGAGTCC	TCGAGTCC
TTGTCNCG	TTGTCCGA
TTGTCNGA	TTGTCCGA
NAATTCGT	GAATTCGT
TTGTGCCG	TTGTCCGA
TTGTGCGA	TTGTCCGA
TNCCATGT	TGCCATGT
TTGTGGAA	TTTGTGGA
TTGTGGAC	TTTGTGGA
TTGTGGAG	TTTGTGGA
TTGTGGAT	TTTGTGGA
TTGTGGAN	TTTGTGGA
TTGTGGGG	TGTGGGGT
TNTGGGGT	TGTGGGGT
TTGTGTGG	TTTGTGGA
TTGTGTTC	TTGCGTTC
TNCCCGGC	TCCCGGCT
TTGTTCCG	TTGTCCGA
TNTGTCCG	TTGTCCGA
TTGTTCGA	TTGTCCGA
TNTGTGGA	TTTGTGGA
TTGTTTTG	TGTTTTGC
TNCCGGCT	TCCCGGCT
TTGTNCCG	TTGTCCGA
TTGTNCGA	TTGTCCGA
NATAGAAA	GATAGAAA
NATAGCTT	AATAGCTT
TNAACAAC	TCAACAAC
TNAACCAG	TAACCAGC
TNGCCATG	TGCCATGT
TNAAGATC	TAAGATCG
TNAATTAC	TAATTACA
TNTTGGCG	TATTGGCG
TNTTGTGG	TTTGTGGA
TNTTTTGC	TGTTTTGC
NAAAACAT	AAAACATG
NATCCGCC	ATCCGCCA
TNACCAGC	TAACCAGC
NAAAATCC	AAAATCCC
NAAAATTT	GAAAATTT
NAAACATG	AAAACATG
NACGCCCA	TACGCCCA
TNACGCCC	TACGCCCA
NATCGACT	ATCGACTT
NAAACGTT	AAACGTTC
NAAACTAA	AAACTAAC
TNACGGTA	TACGGTAT
NATCGGAA	ATCGGAAA
NACAGGAC	ACAGGACT
NACGGTAT	TACGGTAT
NAAATCCC	AAAATCCC
NAAATGTA	AAATGTAG
NAAATTGG	CAAATTGG
NACATTAT	GACATTAT
NATGACCG	AATGACCG
TNGTCCGA	TTGTCCGA
TNGTCTGG	TCGTCTGG
NACTAAGC	ACTAAGCG
NCATCCAT	GCATCCAT
NACTAGTT	CACTAGTT
TNGTGGGG	TGTGGGGT
NACCAGAG	CACCAGAG
NAGGCTTA	AGGCTTAA
NATGGGCT	ATGGGCTA
NACCCGAA	ACCCGAAC
TNGTTTTG	TGTTTTGC
NACCCGTC	GACCCGTC
NACCCTGG	AACCCTGG
NAGAGGCC	AGAGGCCG
NAGGTGGT	AGGTGGTT
NAGATAAT	CAGATAAT
NCATTGTC	CCATTGTC
NACCTTCG	CACCTTCG
NATTATAT	ATTATATC
NATTCAAC	ATTCAACC
NCGACGGA	CCGACGGA
NATTCCTG	ATTCCTGA
NAGCAAAG	AGCAAAGG
NAGTCGGT	GAGTCGGT
NAGTCTCA	AGTCTCAG
NACGATAC	ACGATACG
NCGAGTCC	TCGAGTCC
NCGAGTTT	CGAGTTTA
NCGATACG	ACGATACG
NATTGGCG	TATTGGCG
NATTTCCC	GATTTCCC
NCCAAAGA	CCAAAGAG
NAACCAGC	TAACCAGC
NCCAATTT	CCCAATTT
NAACCCTG	AACCCTGG
NCAAAGAG	CCAAAGAG
NAGCTTCT	AGCTTCTT
NCCACCGT	CCCACCGT
NCAAATTG	CAAATTGG
NCAACAAC	TCAACAAC
NAACGTTC	AAACGTTC
NAACTAAC	AAACTAAC
NCAAGGTC	CAAGGTCC
NCCATTGT	CCATTGTC
NCCCAATT	CCCAATTT
NCCCACCG	CCCACCGT
NAAGATCG	TAAGATCG
NCTCTCCA	CTCTCCAT
NCTGGTAC	CCTGGTAC
NCTCTTTA	CTCTTTAA
NCACCAGA	CACCAGAG
NCTGTAGT	CTGTAGTC
NCACCTTC	CACCTTCG
NCCTAATA	GCCTAATA
NCCCGAAC	ACCCGAAC
NCCTAGCG	TCCTAGCG
NAGTTGCG	AAGTTGCG
NCCCGGCT	TCCCGGCT
NCTTAATG	CTTAATGA
NCCTCTCT	TCCTCTCT
NCTTACCG	CTTACCGG
NCCTGGTA	CCTGGTAC
NCCGACGG	CCGACGGA
NGGAGACT	TGGAGACT
NGATTTCC	GATTTCCC
NCGTCTGG	TCGTCTGG
NCGCCCTA	CCGCCCTA
NCGCCGGG	GCGCCGGG
NCCGCCCT	CCGCCCTA
NCGCGAAG	GCGCGAAG
NCGTGTTA	GCGTGTTA
NCCGGGCG	CCGGGCGT
NCGTTGAA	CCGTTGAA
NCCGTTGA	CCGTTGAA
NATAAGGG	TATAAGGG
NGCATCCA	GCATCCAT
NGAAGGGT	GAAGGGTA
NCGGGAAC	CGGGAACC
NGCAAAGG	AGCAAAGG
NCGGGCGT	CCGGGCGT
NCGGGTAG	CGGGTAGG
NGAATTCG	GAATTCGT
NCACTAGT	CACTAGTT
NGCCATGT	TGCCATGT
NGTCTCAG	AGTCTCAG
NGACATTA	GACATTAT
NGCCTAAT	GCCTAATA
NGACCCGT	GACCCGTC
NCAGATAA	CAGATAAT
NCAGGACT	ACAGGACT
NGTGGCAC	GTGGCACC
NGCTTCTT	AGCTTCTT
NGTGGGGT	TGTGGGGT
NGAAAATT	GAAAATTT
NGTTTAAA	GTTTAAAG
NGTTTGAC	GTTTGACT
NGCGCCGG	GCGCCGGG
NGTTTTGC	TGTTTTGC
NGCGCGAA	GCGCGAAG
NGGTGGTT	AGGTGGTT
NGGCTTAA	AGGCTTAA
NGCGTGTT	GCGTGTTA
NGGGAACC	CGGGAACC
NTGCCATG	TGCCATGT
NGCTAAAT	TGCTAAAT
NTGCGTTC	TTGCGTTC
NGCTAGCT	GCTAGCTC
NTGCTAAA	TGCTAAAT
NTCAAATG	GTCAAATG
NTCAACAA	TCAACAAC
NTCCAAAA	TTCCAAAA
NCTAAGCG	ACTAAGCG
NGGGTAGG	CGGGTAGG
NTCCCGGC	TCCCGGCT
NCTAGCTC	GCTAGCTC
NTGGAGAC	TGGAGACT
NTCAGGCT	GTCAGGCT
NTCCGCCA	ATCCGCCA
NTCCTAGC	TCCTAGCG
NCTATGCA	CTATGCAA
NTCCTCTC	TCCTCTCT
NTTGACAG	TTGACAGC
NTACCGAA	GTACCGAA
NTTGCGTT	TTGCGTTC
NTCGACTT	ATCGACTT
NTCGAGTC	TCGAGTCC
NTACGCCC	TACGCCCA
NTACGGTA	TACGGTAT
NGAGGCAT	TGAGGCAT
NGAGGCCG	AGAGGCCG
NGAGTCGG	GAGTCGGT
NTTGTCCG	TTGTCCGA
NTTGTGGA	TTTGTGGA
NGAGTTTA	CGAGTTTA
NTAACCAG	TAACCAGC
NTAAGATC	TAAGATCG
NTTTAAAG	GTTTAAAG
NGATAGAA	GATAGAAA
NTCGGAAA	ATCGGAAA
NTAATTAC	TAATTACA
NTTTGACT	GTTTGACT
NTCGTCTG	TCGTCTGG
NTGGCACC	GTGGCACC
NTTTGTGG	TTTGTGGA
NTAGGACG	TTAGGACG
NTGGGCTA	ATGGGCTA
NTGACAGC	TTGACAGC
NTCTCCAT	CTCTCCAT
NTGAGGCA	TGAGGCAT
NTGTAGTC	CTGTAGTC
NGTACCGA	GTACCGAA
NTGTCCGA	TTGTCCGA
NTCTTTAA	CTCTTTAA
NTGTGGGG	TGTGGGGT
NTGTTTTG	TGTTTTGC
NTTAATGA	CTTAATGA
NTTACCGG	CTTACCGG
NGTCAAAT	GTCAAATG
NGTCAGGC	GTCAGGCT
NTATAAGG	TATAAGGG
NTATCACT	TTATCACT
NTATGCAA	CTATGCAA
NTATTGGC	TATTGGCG
NTTAGGAC	TTAGGACG
NTTATATC	ATTATATC
NTTATCAC	TTATCACT
NTTCAACC	ATTCAACC
NTTCCAAA	TTCCAAAA
NTTCCTGA	ATTCCTGA
