CCCATCCC	CCCATCCA
CCCATCCA	CCCATCCA
CCCATCCG	CCCATCCA
CCAAGCCA	CAAAGCCA
CCCATCCT	CCCATCCA
CCCATCCN	CCCATCCA
CCCATCAC	CCCATCCA
CCCATCAA	CCCATCCA
CCATCCAC	CCCATCCA
CCCATCAG	CCCATCCA
CCATCCAA	CCCATCCA
CCCATCAT	CCCATCCA
CCATCCAG	CCCATCCA
CCCATCAN	CCCATCCA
CCCATCGC	CCCATCCA
CCATCCAT	CCCATCCA
CCCATCGA	CCCATCCA
CCATCCAN	CCCATCCA
CCATCCGA	CATCCGAG
CCCCCCTG	CCCCACTG
CCCATCTC	CCCATCCA
CCCTACTG	CCCCACTG
CCCATCTA	CCCATCCA
CCCATCNC	CCCATCCA
CCCATCNA	CCCATCCA
CCCCCACT	CCCCACTG
CCCATACC	CCCATCCA
CCCATACA	CCCATCCA
CCCCCAAA	CCCCTAAA
CCCTAAAC	CCCCTAAA
CCCTAAAA	CCCCTAAA
CCCTAAAG	CCCCTAAA
CCCATAAA	CCCCTAAA
CCCTAAAT	CCCCTAAA
CCAAGAAC	CTAAGAAC
CCCTAAAN	CCCCTAAA
CCAAGATG	CCAAATGG
CCCATGCC	CCCATCCA
CCCATGCA	CCCATCCA
CCGAAATG	CCAAATGG
CCCTAGTC	CCCTGTCG
CCCATGTC	CCCTGTCG
CCCTAGTT	CCCAGTTA
CCCATGTT	CCCAGTTA
CCATCGAT	CCTCGATT
CCCTATCC	CCCATCCA
CCCCCTAA	CCCCTAAA
CCCATTCC	CCCATCCA
CCCATTCA	CCCATCCA
CCCTATCG	CCCTGTCG
CCCCCTGC	CCCCACTG
CCCCCTGA	CCCCACTG
CCCATTAC	CCCAGTTA
CCCCCTGG	CCCCACTG
CCCATTAA	CCCAGTTA
CCCCCTGT	CCCCACTG
CCATCGTT	ACATCGTT
CCCATTAG	CCCAGTTA
CCCCCTGN	CCCCACTG
CCCATTAT	CCCAGTTA
CCCATTAN	CCCAGTTA
CCCCCTTT	GCCCCTTT
CCCATTTA	CCCAGTTA
CCAAGTGG	CCAAATGG
CCAAGTTA	CCCAGTTA
CCCATNCC	CCCATCCA
CCCATNCA	CCCATCCA
CCGAATGG	CCAAATGG
CCCCACCG	CCCCACTG
CCCCACCT	CCCCACTG
CCCCACAG	CCCCACTG
CCCCACAT	CCCCACTG
CCCANCCA	CCCATCCA
CCCTGCCG	CCCTGTCG
CCCCACGC	CCCCACTG
CCCCACGA	CCCCACTG
CCCCACGG	CCCCACTG
CCCCACGT	CCCCACTG
CCCTGCAA	CCTGCAAG
CCCCACGN	CCCCACTG
CCCCACTC	CCCCACTG
CCCCACTA	CCCCACTG
CCCCACTG	CCCCACTG
CCCTGCGC	CCCTGTCG
CCCCACTT	CCCCACTG
CCCTGCGA	CCCTGTCG
CCAATCCA	CCCATCCA
CCCCACTN	CCCCACTG
CCCTGCGG	CCCTGTCG
CCCTGCGT	CCCTGTCG
CCCTGCGN	CCCTGTCG
CCCCACNG	CCCCACTG
CCCTGCTC	CCCTGTCG
CCCCACNT	CCCCACTG
CCCCAACT	CCCCACTG
CCCCAAAC	CCCCTAAA
CCCCAAAA	CCCCTAAA
CCCCAAAG	CCCCTAAA
CCCCAAAT	CCCCTAAA
CCCCAAAN	CCCCTAAA
CCCTGACG	CCCTGTCG
CCACCCGG	CGACCCGG
CCCCAATG	CCCCACTG
CCCTGATC	CCCTGTCG
CCCCAGCT	CCCCACTG
CCACCACT	CCCCACTG
CCCTGGCG	CCCTGTCG
CCAATATG	CCAAATGG
CCCCAGTG	CCCCACTG
CCCCAGTT	CCCAGTTA
CCATAATG	CCAAATGG
CCCTGGTC	CCCTGTCG
CCCCATCC	CCCATCCA
CCCANGTT	CCCAGTTA
CCCCATCT	CCCCACTG
CCCCATAA	CCCCTAAA
CCAATGGC	CCAAATGG
CCCTGTCC	CCCTGTCG
CCAATGGA	CCAAATGG
CCCANTCC	CCCATCCA
CCCTGTCA	CCCTGTCG
CCAATGGG	CCAAATGG
CCCCATGC	CCCCACTG
CCCTGTCG	CCCTGTCG
CCAATGGT	CCAAATGG
CCCCATGA	CCCCACTG
CCCTGTCT	CCCTGTCG
CCAATGGN	CCAAATGG
CCCCATGG	CCCCACTG
CCCTGTCN	CCCTGTCG
CCCCATGT	CCCCACTG
CCCTGTAC	CCCTGTCG
CCCCATGN	CCCCACTG
CCCTGTAG	CCCTGTCG
CCCCATTG	CCCCACTG
CCCTGTGC	CCCTGTCG
CCCTGTGA	CCCTGTCG
CCCTGTGG	CCCTGTCG
CCCTGTGT	CCCTGTCG
CCCTGTGN	CCCTGTCG
CCCTGTTC	CCCTGTCG
CCCANTTA	CCCAGTTA
CCCTGTTA	CCCAGTTA
CCCTGTTG	CCCTGTCG
CCCCANCT	CCCCACTG
CCCTGTNC	CCCTGTCG
CCAATTAG	ACAATTAG
CCCTGTNG	CCCTGTCG
CCAATTGG	CCAAATGG
CCCTGNCG	CCCTGTCG
CCACCTAA	CCCCTAAA
CCATATGG	CCAAATGG
CCCCANTG	CCCCACTG
CCCTGNTC	CCCTGTCG
CCGAGTTA	CCCAGTTA
CCCTTCCA	CCCATCCA
CCCTTCAC	TCCTTCAC
CCCCGCTG	CCCCACTG
CCCTTCGC	CCCTGTCG
CCCTTCGA	CCCTGTCG
CCCTTCGG	CCCTGTCG
CCCTTCGT	CCCTGTCG
CCCTTCGN	CCCTGTCG
CCCCGACT	CCCCACTG
CCCCGAAA	CCCCTAAA
CCCGCACT	CCCCACTG
CCATGCAA	CCTGCAAG
CCCGCAAG	CCTGCAAG
CCCCGATT	CCTCGATT
CCCTTAAA	CCCCTAAA
CCGCCACT	CCCCACTG
CCGATCCA	CCCATCCA
CCCTTAGT	GCCTTAGT
CCACACTG	CCCCACTG
CCCTTGAG	CCGTTGAG
CCAANATG	CCAAATGG
CCCTTGGC	ACCCTTGG
CCCTTGGA	ACCCTTGG
CCCTTGGG	ACCCTTGG
CCCTTGGT	ACCCTTGG
CCCCGTCG	CCCTGTCG
CCCTTGGN	ACCCTTGG
CCCTTGTC	CCCTGTCG
CCCCGTAA	CCCCTAAA
CCCCGTTA	CCCAGTTA
CCCGCTAA	CCCCTAAA
CCCGCTAG	TCCGCTAG
CCACAATG	CCAAATGG
CCGCCTAA	CCCCTAAA
CCATGTCG	CCCTGTCG
CCAANTGG	CCAAATGG
CCCCTCCA	CCCATCCA
CCCTTTCG	CCCTGTCG
CCCCTCAA	CCCCTAAA
CCACAGTT	CCCAGTTA
CCGATGAG	CCGTTGAG
CCCCTCTG	CCCCACTG
CCACATCC	CCCATCCA
CCCCTACA	CCCCTAAA
CCCCTACT	CCCCACTG
CCCCTAAC	CCCCTAAA
CCCGACTG	CCCCACTG
CCCCTAAA	CCCCTAAA
CCCCTAAG	CCCCTAAA
CCCCTAAT	CCCCTAAA
CCCCTAAN	CCCCTAAA
CCCCTAGA	CCCCTAAA
CCGCACTG	CCCCACTG
CCCCTATA	CCCCTAAA
CCCCTANA	CCCCTAAA
CCACATGG	CCAAATGG
CCGCAAGC	CCTGCAAG
CCGCAAGA	CCTGCAAG
CCGCAAGG	CCTGCAAG
CCCCTGAA	CCCCTAAA
CCGCAAGT	CCTGCAAG
CCGATTCC	CGGATTCC
CCGCAAGN	CCTGCAAG
CCCCTGTC	CCCTGTCG
CCGATTAT	CGATTATT
CCGATTGA	CCGTTGAG
CCAGCAAG	CCTGCAAG
CCCCTTAA	CCCCTAAA
CCCGAGTT	CCCAGTTA
CCAGCATT	CTAGCATT
CCCCTTGG	ACCCTTGG
CCCGATCC	CCCATCCA
CCGCAGTT	CCCAGTTA
CCCCTTTC	GCCCCTTT
CCCCTTTA	GCCCCTTT
CCCCTTTG	GCCCCTTT
CCCCTTTT	GCCCCTTT
CCCCTTTN	GCCCCTTT
CCGCATCC	CCCATCCA
CCATTATT	CGATTATT
CCCGATTC	CCTCGATT
CCCCTNAA	CCCCTAAA
CCCGATTA	CCTCGATT
CCCGATTG	CCTCGATT
CCCGATTT	CCTCGATT
CCCTNGTC	CCCTGTCG
CCCGATTN	CCTCGATT
CCATTGAG	CCGTTGAG
CCAGCTCA	CAGCTCAG
CCCTNTCG	CCCTGTCG
CCCCNCTG	CCCCACTG
CCCGGCAT	CACGGCAT
CCCCNACT	CCCCACTG
CCCCNAAA	CCCCTAAA
CCCGGAAG	CGCGGAAG
CCACGATT	CCTCGATT
CCGCGATT	CCTCGATT
CCACGGCA	CACGGCAT
CCCNCACT	CCCCACTG
CCGCGGAA	CGCGGAAG
CCAGAAAC	TCAGAAAC
CCCGGGTC	GCCGGGTC
CCCCNTAA	CCCCTAAA
CCAGAATG	CCAAATGG
CCCGGTCG	CCCTGTCG
CCCGGTAA	ACCGGTAA
CCCGGTTA	CCCAGTTA
CCCNCTAA	CCCCTAAA
CCCACCCA	CCCATCCA
CCAGATGG	CCAAATGG
CCCACCAC	CCCATCCA
CCCACCAA	CCCATCCA
CCCACCAG	CCCATCCA
CCCACCAT	CCCATCCA
CCCACCAN	CCCATCCA
CCCGTCCA	CCCATCCA
CCCGTCGC	CCCTGTCG
CCCGTCGA	CCCTGTCG
CCCGTCGG	CCCTGTCG
CCCGTCGT	CCCTGTCG
CCGCTCCT	ACGCTCCT
CCCGTCGN	CCCTGTCG
CCGCTCAG	CAGCTCAG
CCCACACT	CCCCACTG
CCAGGCCC	CTAGGCCC
CCCGTAAA	CCCCTAAA
CCCNACTG	CCCCACTG
CCACTAAA	CCCCTAAA
CCGCTAAA	CCCCTAAA
CCGCTAGC	TCCGCTAG
CCGCTAGA	TCCGCTAG
CCGCTAGG	TCCGCTAG
CCGCTAGT	TCCGCTAG
CCGCTAGN	TCCGCTAG
CCCGTGTC	CCCTGTCG
CCCACGTT	CCCAGTTA
CCCACTCC	CCCATCCA
CCACTGTC	CCCTGTCG
CCGCTGAG	CCGTTGAG
CCCACTAA	CCCCTAAA
CCCGTTAC	CCCAGTTA
CCCGTTAA	CCCAGTTA
CCCGTTAG	CCCAGTTA
CCCGTTAT	CCCAGTTA
CCCGTTAN	CCCAGTTA
CCCACTGC	CCCCACTG
CCGGCAAG	CCTGCAAG
CCCNAGTT	CCCAGTTA
CCCACTGA	CCCCACTG
CCGCTGTC	CCCTGTCG
CCCGTTGA	CCGTTGAG
CCCACTGG	CCCCACTG
CCACTTCT	GCACTTCT
CCCACTGT	CCCCACTG
CCCACTGN	CCCCACTG
CCCACTTA	CCCAGTTA
CCGGCATC	CACGGCAT
CCCNATCC	CCCATCCA
CCGGCATA	CACGGCAT
CCGGCATG	CACGGCAT
CCGGCATT	CACGGCAT
CCGGCATN	CACGGCAT
CCAGGTCT	TCAGGTCT
CCGCTTGA	CCGTTGAG
CCCAACCA	CCCATCCA
CCCAACGA	TCCAACGA
CCCAACTG	CCCCACTG
CCCAAATG	CCAAATGG
CCCAAGTT	CCCAGTTA
CCGGAAGC	CGCGGAAG
CCGGAAGA	CGCGGAAG
CCGGAAGG	CGCGGAAG
CCGGAAGT	CGCGGAAG
CCGGAAGN	CGCGGAAG
CCCAATCC	CCCATCCA
CCCNGTCG	CCCTGTCG
CCANAATG	CCAAATGG
CCCAATGG	CCAAATGG
CCCNGTTA	CCCAGTTA
CCCAATTA	CCCAGTTA
CCAGTTAC	CCCAGTTA
CCAGTTAA	CCCAGTTA
CCAGTTAG	CCCAGTTA
CCAGTTAT	CCCAGTTA
CCAGTTAN	CCCAGTTA
CCAGTTGA	CCGTTGAG
CCCTCCAC	CCCATCCA
CCCTCCAA	CCCATCCA
CCCTCCAG	CCCATCCA
CCCTCCAT	CCCATCCA
CCCTCCAN	CCCATCCA
CCANATGG	CCAAATGG
CCGGATTC	CGGATTCC
CCCNTCCA	CCCATCCA
CCCAGCCA	CCCATCCA
CCCTCACT	CCCCACTG
CCCAGCTA	CCCAGTTA
CCCAGCTT	CCCAGTTA
CCCNTAAA	CCCCTAAA
CCGACCCG	CGACCCGG
CCCTCGAT	CCTCGATT
CCAACATG	CCAAATGG
CCCTCGTC	CCCTGTCG
CCAACGCG	ACAACGCG
CCCAGATA	CCCAGTTA
CCAACGAC	TCCAACGA
CCAACGAA	TCCAACGA
CCCAGATT	CCCAGTTA
CCAACGAG	TCCAACGA
CCAACGAT	TCCAACGA
CCAACGAN	TCCAACGA
CCCTCTCG	CCCTGTCG
CCCNTGTC	CCCTGTCG
CCCTCTAA	CCCCTAAA
CCGGGATC	CTGGGATC
CCCAGGTA	CCCAGTTA
CCCAGGTT	CCCAGTTA
CCAACTGG	CCAAATGG
CCCAGTCC	CCCATCCA
CCCAGTCA	CCCAGTTA
CCCAGTCG	CCCTGTCG
CCCAGTCT	CCCAGTTA
CCCAGTAC	CCCAGTTA
CCCAGTAA	CCCAGTTA
CCCAGTAG	CCCAGTTA
CCCAGTAT	CCCAGTTA
CCCAGTAN	CCCAGTTA
CCCAGTGA	CCCAGTTA
CCCAGTGT	CCCAGTTA
CCGGGTCC	GCCGGGTC
CCCAGTTC	CCCAGTTA
CCGGGTCA	GCCGGGTC
CCCAGTTA	CCCAGTTA
CCGGGTCG	GCCGGGTC
CCGGGTCT	GCCGGGTC
CCCAGTTG	CCCAGTTA
CCGGGTCN	GCCGGGTC
CCCAGTTT	CCCAGTTA
CCCAGTTN	CCCAGTTA
CCCAGTNA	CCCAGTTA
CCCAGTNT	CCCAGTTA
CCTACCAA	CTTACCAA
CCAAACGG	CCAAATGG
CCCAGNTA	CCCAGTTA
CCAAACTG	CCAAATGG
CCCAGNTT	CCCAGTTA
CCTACAAG	CCTGCAAG
CCAAAAGG	CCAAATGG
CCAAAATG	CCAAATGG
CCAAAGCC	CAAAGCCA
CCTACGAT	CCTCGATT
CCGGTAAC	ACCGGTAA
CCGGTAAA	ACCGGTAA
CCGGTAAG	ACCGGTAA
CCAAAGGC	CCAAATGG
CCGGTAAT	ACCGGTAA
CCAAAGGA	CCAAATGG
CCGGTAAN	ACCGGTAA
CCAAAGGG	CCAAATGG
CCAAAGGT	CCAAATGG
CCAAAGGN	CCAAATGG
CCAAAGTA	GCAAAGTA
CCAAAGTG	CCAAATGG
CCAAATCG	CCAAATGG
CCAAATAG	CCAAATGG
CCGGTGAG	CCGTTGAG
CCAAATGC	CCAAATGG
CCAAATGA	CCAAATGG
CCAAATGG	CCAAATGG
CCGGTGGT	CGGTGGTT
CCAAATGT	CCAAATGG
CCAAATGN	CCAAATGG
CCAAATTG	CCAAATGG
CCAAATNG	CCAAATGG
CCGGTTGA	CCGTTGAG
CCAAANGG	CCAAATGG
CCAAANTG	CCAAATGG
CCTGTCAA	CCTGCAAG
CCTGTCGC	CCCTGTCG
CCTGTCGA	CCCTGTCG
CCTGTCGG	CCCTGTCG
CCTGTCGT	CCCTGTCG
CCTGTCGN	CCCTGTCG
CCTNGCAA	CCTGCAAG
CCTGTAAG	CCTGCAAG
CCTAAATG	CCAAATGG
CCGNTGAG	CCGTTGAG
CCTAAGAA	CTAAGAAC
CCTNGATT	CCTCGATT
CCGNTTGA	CCGTTGAG
CCTAATGC	CTTAATGC
CCTAATGG	CCAAATGG
CCTGTTGA	CCGTTGAG
CCGTCGAG	CCGTTGAG
CCGTCGAT	CCTCGATT
CCTAGCAA	CCTGCAAG
CCTAGCAT	CTAGCATT
CCTGNCAA	CCTGCAAG
CCGTCTGA	CCGTTGAG
CCNGTTGA	CCGTTGAG
CCTGNAAG	CCTGCAAG
CCTAGATT	CCTCGATT
CCTAGGCC	CTAGGCCC
CCNAAATG	CCAAATGG
CCTAGTTA	CCCAGTTA
CCTATCCA	CCCATCCA
CCNAATGG	CCAAATGG
CCGTAGAG	CCGTTGAG
CCGTAGGT	GCGTAGGT
CCTCCACT	CCCCACTG
CCTCCAAG	CCTGCAAG
CCTATACG	CGTATACG
CCTTCACC	TCCTTCAC
CCGTATAC	CGTATACG
CCTTCACA	TCCTTCAC
CCTTCACG	TCCTTCAC
CCTTCACT	TCCTTCAC
CCTTCACN	TCCTTCAC
CCTCCATT	CCTCGATT
CCTTCAAG	CCTGCAAG
CCGTATGA	CCGTTGAG
CCTCCGAG	CATCCGAG
CCTCCGAT	CCTCGATT
CCTCCGGG	TCTCCGGG
CCTTCGAT	CCTCGATT
CCTCCTAA	CCCCTAAA
CCTTCTCT	CTTCTCTA
CCGTGCAA	CCTGCAAG
CCGTGAGC	CCGTTGAG
CCGTGAGA	CCGTTGAG
CCNTCGAT	CCTCGATT
CCGTGAGG	CCGTTGAG
CCGTGAGT	CCGTTGAG
CCGTGAGN	CCGTTGAG
CCTTACCA	CTTACCAA
CCNAGTTA	CCCAGTTA
CCTCACTG	CCCCACTG
CCGTGGAG	CCGTTGAG
CCTCAAGC	CCTGCAAG
CCTCAAGA	CCTGCAAG
CCTCAAGG	CCTGCAAG
CCTCAAGT	CCTGCAAG
CCTCAAGN	CCTGCAAG
CCGTGGTT	CGGTGGTT
CCTCAATT	CCTCGATT
CCNATCCA	CCCATCCA
CCGTGTCG	CCCTGTCG
CCTTAATG	CTTAATGC
CCNCCACT	CCCCACTG
CCTCAGAT	CCTCGATT
CCGTGTGA	CCGTTGAG
CCTCAGTT	CCCAGTTA
CCTCATCC	CCCATCCA
CCTTAGTC	GCCTTAGT
CCTTAGTA	GCCTTAGT
CCTTAGTG	GCCTTAGT
CCTTAGTT	GCCTTAGT
CCTTAGTN	GCCTTAGT
CCTCATTC	CCTCGATT
CCTCATTA	CCTCGATT
CCTCATTG	CCTCGATT
CCTCATTT	CCTCGATT
CCTCATTN	CCTCGATT
CCNCCTAA	CCCCTAAA
CCGTTCAG	CCGTTGAG
CCGTTCGA	CCGTTGAG
CCTCGCCC	GCTCGCCC
CCTCGCAA	CCTGCAAG
CCTCGCAT	CCTCGATT
CCTGCCAA	CCTGCAAG
CCTGCCAG	CCTGCAAG
CCGTTAAG	CCGTTGAG
CCTCGCTT	CCTCGATT
CCTTGCAA	CCTGCAAG
CCGTTAGC	CCGTTGAG
CCGTTAGA	CCGTTGAG
CCGTTAGG	CCGTTGAG
CCGTTAGT	CCGTTGAG
CCGTTAGN	CCGTTGAG
CCTCGACT	CCTCGATT
CCTGCACA	CCTGCAAG
CCTGCACG	CCTGCAAG
CCTCGAAT	CCTCGATT
CCTGCAAC	CCTGCAAG
CCTGCAAA	CCTGCAAG
CCTGCAAG	CCTGCAAG
CCTGCAAT	CCTGCAAG
CCGTTGCA	CCGTTGAG
CCTGCAAN	CCTGCAAG
CCTCGAGT	CCTCGATT
CCGTTGCG	CCGTTGAG
CCTGCAGC	CCTGCAAG
CCTGCAGA	CCTGCAAG
CCTCGATC	CCTCGATT
CCNCACTG	CCCCACTG
CCTGCAGG	CCTGCAAG
CCTCGATA	CCTCGATT
CCTGCAGT	CCTGCAAG
CCTCGATG	CCTCGATT
CCGTTGAC	CCGTTGAG
CCTGCAGN	CCTGCAAG
CCTCGATT	CCTCGATT
CCGTTGAA	CCGTTGAG
CCTCGATN	CCTCGATT
CCTGCATA	CCTGCAAG
CCGTTGAG	CCGTTGAG
CCTGCATG	CCTGCAAG
CCGTTGAT	CCGTTGAG
CCGTTGAN	CCGTTGAG
CCTTGAGC	CCGTTGAG
CCTCGANT	CCTCGATT
CCTTGAGA	CCGTTGAG
CCGTTGGC	CCGTTGAG
CCTTGAGG	CCGTTGAG
CCTGCANA	CCTGCAAG
CCGTTGGA	CCGTTGAG
CCTTGAGT	CCGTTGAG
CCTGCANG	CCTGCAAG
CCGTTGGG	CCGTTGAG
CCTTGAGN	CCGTTGAG
CCGTTGGT	CCGTTGAG
CCGTTGGN	CCGTTGAG
CCTTGATT	CCTCGATT
CCGTTGTA	CCGTTGAG
CCGTTGTG	CCGTTGAG
CCTCGGAT	CCTCGATT
CCTGCGAA	CCTGCAAG
CCTGCGAG	CCTGCAAG
CCTGCGAT	CCTCGATT
CCGTTGNA	CCGTTGAG
CCGTTGNG	CCGTTGAG
CCTCGGTT	CCTCGATT
CCTTGGAG	TCTTGGAG
CCNTGCAA	CCTGCAAG
CCGTTTAG	CCGTTGAG
CCGTTTGA	CCGTTGAG
CCTCGTAT	CCTCGATT
CCTGCTAA	CCTGCAAG
CCTGCTAG	CCTGCAAG
CCTTGTCG	CCCTGTCG
CCNCAGTT	CCCAGTTA
CCTCGTTC	CCTCGATT
CCTCGTTA	CCTCGATT
CCTCGTTG	CCTCGATT
CCTCGTTT	CCTCGATT
CCTCGTTN	CCTCGATT
CCNCATCC	CCCATCCA
CCGTTNAG	CCGTTGAG
CCGTTNGA	CCGTTGAG
CCTCGNAT	CCTCGATT
CCTGCNAA	CCTGCAAG
CCTGCNAG	CCTGCAAG
CCTCGNTT	CCTCGATT
CCTGACAA	CCTGCAAG
CCTCTCTA	CTTCTCTA
CCNTGTCG	CCCTGTCG
CCTCTAAA	CCCCTAAA
CCTGAAAG	CCTGCAAG
CCTGAAGC	CCTGCAAG
CCTGAAGA	CCTGCAAG
CCTGAAGG	CCTGCAAG
CCTGAAGT	CCTGCAAG
CCTTTAAA	GCTTTAAA
CCTGAAGN	CCTGCAAG
CCTCTATT	CCTCGATT
CACCCACT	CCCCACTG
CCTCTGAT	CCTCGATT
CCNCGATT	CCTCGATT
CCGTNGAG	CCGTTGAG
CCTCTGTC	CCCTGTCG
CCTTTGAG	CCGTTGAG
CACCCGCG	AACCCGCG
CCNGCAAG	CCTGCAAG
CACCCGAG	CATCCGAG
CACCCGGC	CGACCCGG
CACCCGGA	CGACCCGG
CACCCGGG	CGACCCGG
CACCCGGT	CGACCCGG
CACCCGGN	CGACCCGG
CCTGATTC	CCTCGATT
CCTGATTA	CCTCGATT
CCTGATTG	CCTCGATT
CCTGATTT	CCTCGATT
CCTGATTN	CCTCGATT
CCGTNTGA	CCGTTGAG
CACCCTAA	CCCCTAAA
CACCCTTG	ACCCTTGG
CCNTTGAG	CCGTTGAG
CCTGGCAA	CCTGCAAG
CACCACCA	TACCACCA
CCTGGAAG	CCTGCAAG
CACCACTG	CCCCACTG
CCTGGATT	CCTCGATT
CCNCTAAA	CCCCTAAA
CCTGGGAT	CTGGGATC
CCTCNATT	CCTCGATT
CCTCNGAT	CCTCGATT
CCNCTGTC	CCCTGTCG
CACCAGTT	CCCAGTTA
CACCATCC	CCCATCCA
CAAGCCAC	CAAAGCCA
CAAGCCAA	CAAAGCCA
CAAGCCAG	CAAAGCCA
CAAGCCAT	CAAAGCCA
CAAGCCAN	CAAAGCCA
CACCGCAT	CACGGCAT
CCTNCAAG	CCTGCAAG
CAAGCAGG	AAGCAGGC
CACCGAGC	CATCCGAG
CACCGAGA	CATCCGAG
CAAGCATT	CTAGCATT
CACCGAGG	CATCCGAG
CACCGAGT	CATCCGAG
CACCGAGN	CATCCGAG
CAATTAGC	ACAATTAG
CAATTAGA	ACAATTAG
CAATTAGG	ACAATTAG
CAATTAGT	ACAATTAG
CAATTAGN	ACAATTAG
CAATTATT	CGATTATT
CCTNCGAT	CCTCGATT
CACCGGCA	CACGGCAT
CACGACAT	CACGGCAT
CAGCACAG	CAGCTCAG
CACCGGTA	ACCGGTAA
CAAGCTCA	CAGCTCAG
CAACGCCA	CAAAGCCA
CAGCAGGC	AAGCAGGC
CAACGCGC	ACAACGCG
CAACGCGA	ACAACGCG
CAACGCGG	ACAACGCG
CAACGCGT	ACAACGCG
CAACGCGN	ACAACGCG
CAGCATCA	CAGCTCAG
CAAGAACC	CTAAGAAC
CAAGAACA	CTAAGAAC
CAAGAACG	CTAAGAAC
CAAGAACT	CTAAGAAC
CAAGAACN	CTAAGAAC
CAAGAAAT	AAGAAATC
CAGCATTC	CTAGCATT
CAGCATTA	CTAGCATT
CAGCATTG	CTAGCATT
CAGCATTT	CTAGCATT
CACCTCAG	CAGCTCAG
CAGCATTN	CTAGCATT
CAACGGCA	CACGGCAT
CAAGAGCC	CAAAGCCA
CACCTAAA	CCCCTAAA
CAGCGCAG	CAGCTCAG
CACGAGCA	CACGGCAT
CACCTGTC	CCCTGTCG
CAAGGCCC	CTAGGCCC
CAGCGGCA	CACGGCAT
CAAGGCCA	CAAAGCCA
CAACTCAG	CAGCTCAG
CAGGCCCC	CTAGGCCC
CAGCGGAA	CGCGGAAG
CAGGCCCA	CTAGGCCC
CAGGCCCG	CTAGGCCC
CAAGGCAT	CACGGCAT
CAGGCCCT	CTAGGCCC
CAGGCCCN	CTAGGCCC
CAGCGTCA	CAGCTCAG
CAGCGTAA	TAGCGTAA
CAGCGTTT	AGCGTTTC
CAGGCATC	CACGGCAT
CAGGCATA	CACGGCAT
CAGGCATG	CACGGCAT
CAGGCATT	CACGGCAT
CAGGCATN	CACGGCAT
CAAGGGAG	AAGGGAGT
CACGGCCA	CACGGCAT
CACGGCCT	CACGGCAT
CACGGCAC	CACGGCAT
CACGGCAA	CACGGCAT
CACGGCAG	CACGGCAT
CACGGCAT	CACGGCAT
CACGGCAN	CACGGCAT
CACGGCGA	CACGGCAT
CACGGCGT	CACGGCAT
CACGGCTC	CACGGCAT
CACGGCTA	CACGGCAT
CACGGCTG	CACGGCAT
CACGGCTT	CACGGCAT
CAGCTCCA	CAGCTCAG
CACGGCTN	CACGGCAT
CAGCTCCG	CAGCTCAG
CACGGCNA	CACGGCAT
CAGCTCAC	CAGCTCAG
CAGCTCAA	CAGCTCAG
CACGGCNT	CACGGCAT
CAGGCTCA	CAGCTCAG
CAGCTCAG	CAGCTCAG
CAGCTCAT	CAGCTCAG
CAGCTCAN	CAGCTCAG
CACGGACA	CACGGCAT
CAGCTCGC	CAGCTCAG
CAACTTGT	AACTTGTA
CAGCTCGA	CAGCTCAG
CAGCTCGG	CAGCTCAG
CAGCTCGT	CAGCTCAG
CAGCTCGN	CAGCTCAG
CACGGAAG	CGCGGAAG
CAGCTCTA	CAGCTCAG
CACGGAAT	CACGGCAT
CAGCTCTG	CAGCTCAG
CAGCTCNA	CAGCTCAG
CAGCTCNG	CAGCTCAG
CACGGATC	CACGGCAT
CACGGATA	CACGGCAT
CACGGATG	CACGGCAT
CAGCTACA	CAGCTCAG
CACGGATT	CACGGCAT
CACGGATN	CACGGCAT
CAGCTAAG	CAGCTCAG
CACGGGCA	CACGGCAT
CAGCTAGC	CAGCTCAG
CAGCTAGA	CAGCTCAG
CAGCTAGG	CAGCTCAG
CAGCTAGT	CAGCTCAG
CAGCTAGN	CAGCTCAG
CACGGGAT	CACGGCAT
CACNGCAT	CACGGCAT
CAGCTGCA	CAGCTCAG
CAGCTGAG	CAGCTCAG
CACGGTCA	CACGGCAT
CACGGTAT	CACGGCAT
CAGCTTCA	CAGCTCAG
CAANAGCC	CAAAGCCA
CAGCTTAG	CAGCTCAG
CACGGNCA	CACGGCAT
CACGGNAT	CACGGCAT
CACNGGCA	CACGGCAT
CAGCTNCA	CAGCTCAG
CAGCTNAG	CAGCTCAG
CACGTCAT	CACGGCAT
CAGCNCAG	CAGCTCAG
CAAGTTGC	AAGTTGCC
CAGGATTC	CGGATTCC
CAANGCCA	CAAAGCCA
CACGTGCA	CACGGCAT
CAAACCCA	CAAAGCCA
CAAACCAC	CAAAGCCA
CAGGGCCA	AGGGCCAA
CAAACCAA	CAAAGCCA
CAAACCAG	CAAAGCCA
CAAACCAT	CAAAGCCA
CAAACCAN	CAAAGCCA
CAGGGCAT	CACGGCAT
CAAACCTT	AAACCTTT
CACGTTGA	CCGTTGAG
CAGCNTCA	CAGCTCAG
CAAACAAG	AAACAAGT
CAGGGAGT	AAGGGAGT
CAGGGATC	CTGGGATC
CAAACGCC	CAAAGCCA
CACGNCAT	CACGGCAT
CAGACCCG	CGACCCGG
CAGGGTCG	AGGGTCGG
CACAACGC	ACAACGCG
CACGNGCA	CACGGCAT
CAAAACCA	CAAAGCCA
CAATCCGA	CATCCGAG
CAGGTCAG	CAGCTCAG
CACAAATG	CCAAATGG
CAATCCTC	GAATCCTC
CAGGTCTC	TCAGGTCT
CAGGTCTA	TCAGGTCT
CAGGTCTG	TCAGGTCT
CAGGTCTT	TCAGGTCT
CACAAGCC	CAAAGCCA
CAGGTCTN	TCAGGTCT
CAGACTCA	CAGCTCAG
CAATCGAG	TAATCGAG
CAAAAGCC	CAAAGCCA
CAGGTGGT	CGGTGGTT
CACAATTA	ACAATTAG
CACTCCGA	CATCCGAG
CAAAATGG	CCAAATGG
CAGAAACC	TCAGAAAC
CACTCAGC	CAGCTCAG
CAGAAACA	TCAGAAAC
CACTCAGA	CAGCTCAG
CAGAAACG	TCAGAAAC
CACTCAGG	CAGCTCAG
CAGAAACT	TCAGAAAC
CACTCAGT	CAGCTCAG
CAGAAACN	TCAGAAAC
CACTCAGN	CAGCTCAG
CACAGCCA	CAAAGCCA
CAGAAATC	AAGAAATC
CACAGCAT	CACGGCAT
CACTCGAT	CCTCGATT
CAGAAGCC	CAAAGCCA
CAAAGCCC	CAAAGCCA
CAACCCGC	AACCCGCG
CAAAGCCA	CAAAGCCA
CAAAGCCG	CAAAGCCA
CAACCCGG	CGACCCGG
CAAAGCCT	CAAAGCCA
CAAAGCCN	CAAAGCCA
CAGAAGGG	GAGAAGGG
CAAAGCAC	CAAAGCCA
CAAAGCAA	CAAAGCCA
CAAAGCAG	CAAAGCCA
CAAAGCAT	CAAAGCCA
CAAAGCAN	CAAAGCCA
CAAAGCGC	CAAAGCCA
CAAAGCGA	CAAAGCCA
CAAAGCTC	CAAAGCCA
CAAAGCTA	CAAAGCCA
CAAAGCNC	CAAAGCCA
CAAAGCNA	CAAAGCCA
CAAAGACC	CAAAGCCA
CAAAGACA	CAAAGCCA
CAAAGAAC	CTAAGAAC
CACAGGCA	CACGGCAT
CAATAGCC	CAAAGCCA
CAACCGAG	CATCCGAG
CAAAGGCC	CAAAGCCA
CAAAGGCA	CAAAGCCA
CAAAGGAT	TAAAGGAT
CAGAGCCA	CAAAGCCA
CAGAGCCG	GAGAGCCG
CAAAGTCC	CAAAGCCA
CAATATAT	TAATATAT
CAAAGTCA	CAAAGCCA
CAAAGTAC	GCAAAGTA
CACAGTTA	CCCAGTTA
CAAAGTAA	GCAAAGTA
CAAAGTAG	GCAAAGTA
CAAAGTAT	GCAAAGTA
CAACCTTT	AAACCTTT
CAAAGTAN	GCAAAGTA
CACTAACT	GACTAACT
CAAAGNCC	CAAAGCCA
CAAAGNCA	CAAAGCCA
CAGCCCAG	CAGCTCAG
CAATGCCA	CAAAGCCA
CACATCCA	CCCATCCA
CAAATCCA	CAAAGCCA
CAGTCCGA	CATCCGAG
CACATCGT	ACATCGTT
CAGCCAGC	CAGCTCAG
CAGCCAGA	CAGCTCAG
CAGCCAGG	CAGCTCAG
CAGCCAGT	CAGCTCAG
CAGCCAGN	CAGCTCAG
CAACAAGT	AAACAAGT
CAGTCAGC	CAGCTCAG
CAGTCAGA	CAGCTCAG
CAGTCAGG	CAGCTCAG
CAGTCAGT	CAGCTCAG
CAGCCGAG	CATCCGAG
CAGTCAGN	CAGCTCAG
CAACAGCC	CAAAGCCA
CAAATGCC	CAAAGCCA
CAGCCTCA	CAGCTCAG
CAATGGTC	AATGGTCA
CAAATGGC	CCAAATGG
CAAATGGA	CCAAATGG
CAAATGGG	CCAAATGG
CAAATGGT	CCAAATGG
CAAATGGN	CCAAATGG
CAGATCAG	CAGCTCAG
CACTGCAA	CCTGCAAG
CACTGCAT	CACGGCAT
CAGTCTCA	CAGCTCAG
CANAGCCA	CAAAGCCA
CACTGGCA	CACGGCAT
CAAANCCA	CAAAGCCA
CAGATTCC	CGGATTCC
CATATACG	CGTATACG
CACTGTCG	CCCTGTCG
CAGATTAT	CGATTATT
CATATAAC	ATATAACT
CAAANGCC	CAAAGCCA
CANTCCGA	CATCCGAG
CATATTTC	ATATTTCC
CAGTATAC	CGTATACG
CACTTCTC	GCACTTCT
CACTTCTA	GCACTTCT
CACTTCTG	GCACTTCT
CACTTCTT	GCACTTCT
CACTTCTN	GCACTTCT
CAGTATGG	TAGTATGG
CATTACCA	CTTACCAA
CACGCCAT	CACGGCAT
CATTAATG	CTTAATGC
CANCCGAG	CATCCGAG
CACTTGTA	AACTTGTA
CACGCATC	CACGGCAT
CACGCATA	CACGGCAT
CACGCATG	CACGGCAT
CACGCATT	CACGGCAT
CACGCATN	CACGGCAT
CACGCGCA	CACGGCAT
CATTATTC	CGATTATT
CATTATTA	CGATTATT
CATTATTG	CGATTATT
CATTATTT	CGATTATT
CATTATTN	CGATTATT
CACGCTCC	ACGCTCCT
CACGCTCA	CAGCTCAG
CATCCCAG	CATCCGAG
CATCCCGA	CATCCGAG
CATGCCGA	CATCCGAG
CATCCAAG	CATCCGAG
CATCCAGC	CATCCGAG
CATCCAGA	CATCCGAG
CATCCAGG	CATCCGAG
CATGCAAG	CCTGCAAG
CATCCAGT	CATCCGAG
CATCCAGN	CATCCGAG
CATCCGCA	CATCCGAG
CATCCGCG	CATCCGAG
CATCCGAC	CATCCGAG
CATCCGAA	CATCCGAG
CATCCGAG	CATCCGAG
CATCCGAT	CATCCGAG
CATCCGAN	CATCCGAG
CATCCGGC	CATCCGAG
CATCCGGA	CATCCGAG
CATCCGGG	CATCCGAG
CATGCGAG	CATCCGAG
CATCCGGT	CATCCGAG
CATCCGGN	CATCCGAG
CATCCGTA	CATCCGAG
CATCCGTG	CATCCGAG
CATCCGNA	CATCCGAG
CATCCGNG	CATCCGAG
CATGCTCA	CAGCTCAG
CATCCTAG	CATCCGAG
CATCCTGA	CATCCGAG
CATCCNAG	CATCCGAG
CATCCNGA	CATCCGAG
CATCACGA	CATCCGAG
CAGTGGTT	CGGTGGTT
CGCCCCGG	CGACCCGG
CGCCCCTT	GCCCCTTT
CAGTGTTC	GAGTGTTC
CGCCCACT	CCCCACTG
CANGCTCA	CAGCTCAG
CANCGGCA	CACGGCAT
CATCAGAG	CATCCGAG
CGCCCGGC	CGACCCGG
CGCCCGGA	CGACCCGG
CGCCCGGG	CGACCCGG
CGCCCGGT	CGACCCGG
CGCCCGGN	CGACCCGG
CAGTTCAG	CAGCTCAG
CGCCCTAA	CCCCTAAA
CATGGCAT	CACGGCAT
CAGTTGCC	AAGTTGCC
CANCTCAG	CAGCTCAG
CAGTTGAG	CCGTTGAG
CGCCACTG	CCCCACTG
CATGGGAT	CTGGGATC
CATCGCGA	CATCCGAG
CATGGTCA	AATGGTCA
CGCCAGTT	CCCAGTTA
CGCCATCC	CCCATCCA
CANGGCAT	CACGGCAT
CATGTCGT	ATGTCGTA
CATCGAGC	CATCCGAG
CATCGAGA	CATCCGAG
CATCGAGG	CATCCGAG
CATCGAGT	CATCCGAG
CATCGAGN	CATCCGAG
CATCGATA	GATCGATA
CATCGATT	CCTCGATT
CATCGGCA	CACGGCAT
CATCGGAG	CATCCGAG
CGCCGAAG	CGCGGAAG
CGCCGGAA	CGCGGAAG
CGCCGGGT	GCCGGGTC
CATNCCGA	CATCCGAG
CATCGTTC	ACATCGTT
CATCGTTA	ACATCGTT
CATCGTTG	ACATCGTT
CATCGTTT	ACATCGTT
CATCGTTN	ACATCGTT
CATNCGAG	CATCCGAG
CATCTCAG	CAGCTCAG
CATCTCGA	CATCCGAG
CATCTCTA	CTTCTCTA
CGCCTAAA	CCCCTAAA
CATCTGAC	ATCTGACC
CATCTGAG	CATCCGAG
CGCCTGTC	CCCTGTCG
CAGNCTCA	CAGCTCAG
CGCCTTAG	GCCTTAGT
CATTCCGA	CATCCGAG
CATTCCTG	ATTCCTGC
CATCNCGA	CATCCGAG
CATTCAAG	ATTCAAGG
CATTCGAG	CATCCGAG
CANAAGCC	CAAAGCCA
CATTCTCT	CTTCTCTA
CATCNGAG	CATCCGAG
CGCACCCG	CGACCCGG
CATACCAA	CTTACCAA
CGCNGAAG	CGCGGAAG
CATACCGA	CATCCGAG
CGAGTATT	CGATTATT
CGCNGGAA	CGCGGAAG
CGAGTGGT	CGGTGGTT
CGAGTGTT	GAGTGTTC
CATACGAG	CATCCGAG
CGAGTTAT	CGATTATT
CGCACTTC	GCACTTCT
CGGGGAAG	CGCGGAAG
CGGGGATC	CTGGGATC
CAGNTCAG	CAGCTCAG
CGGGGGTT	CGGTGGTT
CGAACCCG	CGACCCGG
CGAACCGG	CGACCCGG
CGGACCCG	CGACCCGG
CGGGGTTC	CGGTGGTT
CGGGGTTA	CGGTGGTT
CGGGGTTG	CGGTGGTT
CGGGGTTT	CGGTGGTT
CGGGGTTN	CGGTGGTT
CATAAGCC	CAAAGCCA
CATAAGAA	CTAAGAAC
CGANTATT	CGATTATT
CGATCCCG	CGACCCGG
CGATCCCT	TGATCCCT
CGATCCGA	CATCCGAG
CATAATGC	CTTAATGC
CGATCCGG	CGACCCGG
CGGGTCGG	AGGGTCGG
CGANTTAT	CGATTATT
CGGACTCC	CGGATTCC
CGATCATT	CGATTATT
CGAACTGT	TGAACTGT
CATAGCCA	CAAAGCCA
CGGACTTC	CGGATTCC
CGATCGAT	GATCGATA
CATAGCAT	CTAGCATT
CGGGTGGT	CGGTGGTT
CGGGTTCC	CGGATTCC
CGATCTAT	CGATTATT
CATAGGCC	CTAGGCCC
CGACCCCG	CGACCCGG
CGACCCAG	CGACCCGG
CGACCCGC	CGACCCGG
CGACCCGA	CGACCCGG
CGACCCGG	CGACCCGG
CGAAAGCC	CAAAGCCA
CGACCCGT	CGACCCGG
CGACCCGN	CGACCCGG
CGATACGC	CGTATACG
CGATACGA	CGTATACG
CGATACGG	CGTATACG
CGACCCTG	CGACCCGG
CGATACGT	CGTATACG
CGATACGN	CGTATACG
CGACCCNG	CGACCCGG
CGACCACG	CGACCCGG
CGACCAGG	CGACCCGG
CGGAATCC	CGGATTCC
CGATAATT	CGATTATT
CGAAATGG	CCAAATGG
CGACCGCG	CGACCCGG
CGACCGGC	CGACCCGG
CGACCGGA	CGACCCGG
CGGAATTC	CGGATTCC
CGACCGGG	CGACCCGG
CGACCGGT	CGACCCGG
CGACCGGN	CGACCCGG
CGACCTCG	CGACCCGG
CGATATAC	CGTATACG
CGGCCCGG	CGACCCGG
CGACCTGG	CGACCCGG
CGATATAT	CGATTATT
CGAAGCCA	CAAAGCCA
CGCGNAAG	CGCGGAAG
CGATATTC	CGATTATT
CGATATTA	CGATTATT
CGATATTG	CGATTATT
CGATATTT	CGATTATT
CGATATTN	CGATTATT
CGACCNCG	CGACCCGG
CGACCNGG	CGACCCGG
CGCGNGAA	CGCGGAAG
CGAAGAAC	CTAAGAAC
CGACACCG	CGACCCGG
CGCAAAGT	GCAAAGTA
CGACACGG	CGACCCGG
CGCAAATG	CCAAATGG
CGGAGGTT	CGGTGGTT
CGGAGTCC	CGGATTCC
CGATGATT	CGATTATT
CGGAGTTC	CGGATTCC
CGATGGTT	CGGTGGTT
CGGTCGGT	CGGTGGTT
CGCTCCTC	ACGCTCCT
CGCTCCTA	ACGCTCCT
CGCTCCTG	ACGCTCCT
CGCTCCTT	ACGCTCCT
CGGTCGTT	CGGTGGTT
CGCTCCTN	ACGCTCCT
CGATGTAT	CGATTATT
CGCTCAGC	CAGCTCAG
CGAATCCT	GAATCCTC
CGCTCAGA	CAGCTCAG
CGGATCCC	CGGATTCC
CGCTCAGG	CAGCTCAG
CGGATCCA	CGGATTCC
CGCTCAGT	CAGCTCAG
CGGATCCG	CGGATTCC
CGCTCAGN	CAGCTCAG
CGGATCCT	CGGATTCC
CGGATCCN	CGGATTCC
CGCTCGCC	GCTCGCCC
CGGATCTC	CGGATTCC
CGCTCGAT	CCTCGATT
CGAATACG	CGTATACG
CGGATACC	CGGATTCC
CGGATACG	CGTATACG
CGACGCCG	CGACCCGG
CGATTCCC	CGGATTCC
CGATTCCA	CGGATTCC
CGATTCCG	CGGATTCC
CGATTCCT	CGGATTCC
CGATTCCN	CGGATTCC
CGAATATT	CGATTATT
CGGATATC	CGGATTCC
CGATTCAT	CGATTATT
CGACGCGG	CGACCCGG
CGCAGAAG	CGCGGAAG
CGGATGCC	CGGATTCC
CGATTCTT	CGATTATT
CGATTACT	CGATTATT
CGGATGGT	CGGTGGTT
CGGATGTC	CGGATTCC
CGATTAAT	CGATTATT
CGGCATTC	CGGATTCC
CGAATTCC	CGGATTCC
CGATTAGT	CGATTATT
CGATTATC	CGATTATT
CGATTATA	CGATTATT
CGGATTCC	CGGATTCC
CGATTATG	CGATTATT
CGGATTCA	CGGATTCC
CGATTATT	CGATTATT
CGGATTCG	CGGATTCC
CGATTATN	CGATTATT
CGGATTCT	CGGATTCC
CGGATTCN	CGGATTCC
CGAATTAT	CGATTATT
CGCAGGAA	CGCGGAAG
CGGATTAC	CGGATTCC
CGATTANT	CGATTATT
CGACGGCA	CACGGCAT
CGGATTAT	CGATTATT
CGGATTGC	CGGATTCC
CGACGGAA	CGCGGAAG
CGGATTTC	CGGATTCC
CGATTGAT	CGATTATT
CGGATTNC	CGGATTCC
CGGATNCC	CGGATTCC
CGGTAGGT	CGGTGGTT
CGATTGTT	CGATTATT
CGGTAGTT	CGGTGGTT
CGGCGCAT	TGGCGCAT
CGGATNTC	CGGATTCC
CGATTTAT	CGATTATT
CGGTATAC	CGTATACG
CGCAGTTA	CCCAGTTA
CGATTTTC	CGATTATT
CGATTTTA	CGATTATT
CGATTTTG	CGATTATT
CGATTTTT	CGATTATT
CGATTTTN	CGATTATT
CGGTATTC	CGGATTCC
CGATTNAT	CGATTATT
CGATTNTT	CGATTATT
CGACTCCG	CGACCCGG
CGCATCCA	CCCATCCA
CGGCGGAA	CGCGGAAG
CGACTCGG	CGACCCGG
CGCTATAC	CGTATACG
CGGCGGTT	CGGTGGTT
CGGTGCGT	CGGTGGTT
CGGTGCTT	CGGTGGTT
CGACTAAC	GACTAACT
CGCATACG	CGTATACG
CGGANTCC	CGGATTCC
CGATNATT	CGATTATT
CGACTATT	CGATTATT
CGGTGAGT	CGGTGGTT
CGGTGATT	CGGTGGTT
CGGANTTC	CGGATTCC
CGGTGGCT	CGGTGGTT
CGGTGGAT	CGGTGGTT
CGCTGCAA	CCTGCAAG
CGGTGGGT	CGGTGGTT
CGGTGGTC	CGGTGGTT
CGGTGGTA	CGGTGGTT
CGGTGGTG	CGGTGGTT
CGGTGGTT	CGGTGGTT
CGGTGGTN	CGGTGGTT
CGGTGGNT	CGGTGGTT
CGGCTCAG	CAGCTCAG
CGATNTAT	CGATTATT
CGACTTAT	CGATTATT
CGCATTCC	CGGATTCC
CGAGCCCG	CGACCCGG
CGGTGTGT	CGGTGGTT
CGCTGAAG	CGCGGAAG
CGGTGTTC	CGGTGGTT
CGGTGTTA	CGGTGGTT
CGGGCCAA	AGGGCCAA
CGGTGTTG	CGGTGGTT
CGGTGTTT	CGGTGGTT
CGGTGTTN	CGGTGGTT
CGCATTAT	CGATTATT
CGAGCCGG	CGACCCGG
CGGTGNGT	CGGTGGTT
CGCTGGAA	CGCGGAAG
CGGTGNTT	CGGTGGTT
CGANCCCG	CGACCCGG
CGACNCCG	CGACCCGG
CGGTTCCC	CGGATTCC
CGGTTCCA	CGGATTCC
CGCTGGTT	CGGTGGTT
CGAGCATT	CTAGCATT
CGGTTCCG	CGGATTCC
CGGTTCCT	CGGATTCC
CGGTTCCN	CGGATTCC
CGANCCGG	CGACCCGG
CGGCTGGT	CGGTGGTT
CGACNCGG	CGACCCGG
CGCTGTCG	CCCTGTCG
CGGCTTCC	CGGATTCC
CGAGCTCA	CAGCTCAG
CGGTTATT	CGATTATT
CGGTTGAG	CCGTTGAG
CGGTTGGT	CGGTGGTT
CGGTTGTT	CGGTGGTT
CGGTTTCC	CGGATTCC
CGCTTATT	CGATTATT
CGAGAAGG	GAGAAGGG
CGGGAAGC	CGCGGAAG
CGGGAAGA	CGCGGAAG
CGGGAAGG	CGCGGAAG
CGGGAAGT	CGCGGAAG
CGGGAAGN	CGCGGAAG
CGAGAGCC	GAGAGCCG
CGGGATCC	CTGGGATC
CGGGATCA	CTGGGATC
CGGGATCG	CTGGGATC
CGNCGGAA	CGCGGAAG
CGGGATCT	CTGGGATC
CGAGATTC	CGGATTCC
CGGGATCN	CTGGGATC
CGGTNGGT	CGGTGGTT
CGGGATTC	CGGATTCC
CGGTNGTT	CGGTGGTT
CGCGCAAG	CGCGGAAG
CGTGATAC	CGTATACG
CGCTTTAA	GCTTTAAA
CGAGGCCC	CTAGGCCC
CGTGATTC	CGGATTCC
CGCGCGAA	CGCGGAAG
CGAGGAAG	CGCGGAAG
CTCCACTG	CCCCACTG
CGNGATTC	CGGATTCC
CGNTTATT	CGATTATT
CTCCAACG	TCCAACGA
CGTGGACA	GTGGACAA
CGTGGAAG	CGCGGAAG
CGTGGGAT	CTGGGATC
CGTGGGGT	TGTGGGGT
CTCCAGTT	CCCAGTTA
CTCCATCC	CCCATCCA
CGNGGAAG	CGCGGAAG
CGTGGTTC	CGGTGGTT
CGTGGTTA	CGGTGGTT
CGTGGTTG	CGGTGGTT
CGTGGTTT	CGGTGGTT
CGTGGTTN	CGGTGGTT
CGCGAAAG	CGCGGAAG
CGCGAAGC	CGCGGAAG
CGCGAAGA	CGCGGAAG
CGCGAAGG	CGCGGAAG
CGCGAAGT	CGCGGAAG
CGCGAAGN	CGCGGAAG
CGCGAGAA	CGCGGAAG
CTCCGCTA	TCCGCTAG
CGTGTACG	CGTATACG
CTCCGAGC	CATCCGAG
CTCCGAGA	CATCCGAG
CTCCGAGG	CATCCGAG
CTCCGAGT	CATCCGAG
CTCCGAGN	CATCCGAG
CGCGATTC	CGGATTCC
CTCCGGGC	TCTCCGGG
CTCCGGGA	TCTCCGGG
CTCCGGGG	TCTCCGGG
CTCCGGGT	TCTCCGGG
CTCCGGGN	TCTCCGGG
CGTGTGGT	CGGTGGTT
CGCGGCAA	CGCGGAAG
CGCGGCAG	CGCGGAAG
CGCGGCAT	CACGGCAT
CGNGTGGT	CGGTGGTT
CGCGGACA	CGCGGAAG
CGCGGACG	CGCGGAAG
CGCGGACT	TGCGGACT
CGCGGAAC	CGCGGAAG
CGCGGAAA	CGCGGAAG
CGCGGAAG	CGCGGAAG
CGCGGAAT	CGCGGAAG
CGCGGAAN	CGCGGAAG
CGCGGAGC	CGCGGAAG
CGNACCCG	CGACCCGG
CGCGGAGA	CGCGGAAG
CGCGGAGG	CGCGGAAG
CGCGGAGT	CGCGGAAG
CGCGGAGN	CGCGGAAG
CGCGGATA	CGCGGAAG
CGCGGATG	CGCGGAAG
CGCGGANA	CGCGGAAG
CGCGGANG	CGCGGAAG
CTCCTCTA	CTTCTCTA
CGCGGGAA	CGCGGAAG
CGCGGGAG	CGCGGAAG
CTCCTAAA	CCCCTAAA
CGCGGTAA	CGCGGAAG
CGCGGTAG	CGCGGAAG
CTCCTGTC	CCCTGTCG
CTCCTTCA	TCCTTCAC
CGCGGNAA	CGCGGAAG
CGCGGNAG	CGCGGAAG
CGCGTAAG	CGCGGAAG
CGCGTAGG	GCGTAGGT
CGCGTGAA	CGCGGAAG
CGTNATAC	CGTATACG
CGCGTGGT	CGGTGGTT
CGCGTTGA	CCGTTGAG
CGCGTTTC	AGCGTTTC
CGTCTCTA	CTTCTCTA
CGTTCTCT	CTTCTCTA
CGTCTACG	CGTATACG
CTCACCAA	CTTACCAA
CGTTACCA	CTTACCAA
CGTTACGC	CGTATACG
CGTTACGA	CGTATACG
CGTTACGG	CGTATACG
CGTTACGT	CGTATACG
CGTTACGN	CGTATACG
CGTTAATG	CTTAATGC
CGTTATAC	CGTATACG
CGTTATTC	CGATTATT
CGTTATTA	CGATTATT
CGTTATTG	CGATTATT
CGTTATTT	CGATTATT
CGTTATTN	CGATTATT
CGNTATAC	CGTATACG
CGTNTACG	CGTATACG
CGNATACG	CGTATACG
CTCAAATG	CCAAATGG
CGTTGAGC	CCGTTGAG
CGTTGAGA	CCGTTGAG
CTCAAGCC	GTCAAGCC
CGTTGAGG	CCGTTGAG
CGTTGAGT	CCGTTGAG
CGTTGAGN	CCGTTGAG
CTCAAGAA	CTAAGAAC
CGNATTCC	CGGATTCC
CGNATTAT	CGATTATT
CGTTGGTT	CGGTGGTT
CTCAATGC	CTTAATGC
CGGNATTC	CGGATTCC
CGNTGGTT	CGGTGGTT
CTCAGCAT	CTAGCATT
CGTTTCCC	GTTTCCCG
CGTACCCG	CGACCCGG
CGTACCCT	GTACCCTG
CGTACCAA	CTTACCAA
CTCAGAAC	CTAAGAAC
CTCAGAAA	TCAGAAAC
CGTTTACG	CGTATACG
CGTACACG	CGTATACG
CTCAGGCC	CTAGGCCC
CGTTTATT	CGATTATT
CTCAGGTC	TCAGGTCT
CGTTTGCA	GTTTGCAT
CGGNGGTT	CGGTGGTT
CGTACGGA	GTACGGAT
CTCAGTTA	CCCAGTTA
CGTTTTGA	TGTTTTGA
CGTACTAC	CGTATACG
CGNCCCGG	CGACCCGG
CTATACCA	CTTACCAA
CTCATCCA	CCCATCCA
CTATACGC	CGTATACG
CTATACGA	CGTATACG
CTCCCACT	CCCCACTG
CTATACGG	CGTATACG
CTATACGT	CGTATACG
CTATACGN	CGTATACG
CTATAACT	ATATAACT
CTACCCGG	CGACCCGG
CTACCCTG	GTACCCTG
CTATAATG	CTTAATGC
CTACCACC	TACCACCA
CGTAACGC	CGTATACG
CGTAACGA	CGTATACG
CGTAACGG	CGTATACG
CTACCAAC	CTTACCAA
CTACCAAA	CTTACCAA
CTACCAAG	CTTACCAA
CTACCAAT	CTTACCAA
CTACCAAN	CTTACCAA
CGTAACGT	CGTATACG
CGTAACGN	CGTATACG
CTATAGAA	CTAAGAAC
CTACCATT	CTAGCATT
CTCCCTAA	CCCCTAAA
CGGNTGGT	CGGTGGTT
CGTAAACG	CGTATACG
CGGNTTCC	CGGATTCC
CTGAGCAT	CTAGCATT
CTATGCCC	CTAGGCCC
CTATGCAT	CTAGCATT
CTGAGAAC	CTAAGAAC
CGTAAGAA	CTAAGAAC
CTGAGATC	CTGGGATC
CTATGAAC	CTAAGAAC
CTGAGGCC	CTAGGCCC
CTGCACGA	TTGCACGA
CTGAGGAT	CTGGGATC
CGTAATAC	CGTATACG
CGTAATGC	CTTAATGC
CTATGGCC	CTAGGCCC
CTGCAAGC	CCTGCAAG
CTGCAAGA	CCTGCAAG
CTGCAAGG	CCTGCAAG
CTGCAAGT	CCTGCAAG
CTGCAAGN	CCTGCAAG
CTGTCGTA	ATGTCGTA
CTGAGTTA	TTGAGTTA
CTACAGAA	CTAAGAAC
CTGTCTCT	CTTCTCTA
CGTAGCAT	CTAGCATT
CTGATCCC	TGATCCCT
CTACATTC	CTAGCATT
CTACATTA	CTAGCATT
CTACATTG	CTAGCATT
CTACATTT	CTAGCATT
CTACATTN	CTAGCATT
CTAATCGA	TAATCGAG
CTGCATTC	CTAGCATT
CTGCATTA	CTAGCATT
CTGCATTG	CTAGCATT
CTGCATTT	CTAGCATT
CTGCATTN	CTAGCATT
CGTAGACG	CGTATACG
CTGTACCA	CTTACCAA
CTAATAAC	CTAAGAAC
CTAATATA	TAATATAT
CTACGCCC	CTAGGCCC
CGTAGGCC	CTAGGCCC
CTAATGCC	CTTAATGC
CTACGCAT	CTAGCATT
CTAATGCA	CTTAATGC
CGTCCCGG	CGACCCGG
CTAATGCG	CTTAATGC
CTAATGCT	CTTAATGC
CTAATGCN	CTTAATGC
CTAATGAA	CTAAGAAC
CTGTAAGC	TTGTAAGC
CTATTATT	CGATTATT
CTGTAATG	CTTAATGC
CGTAGGTC	GCGTAGGT
CGTAGGTA	GCGTAGGT
CGTAGGTG	GCGTAGGT
CGTAGGTT	GCGTAGGT
CGTAGGTN	GCGTAGGT
CTACGAAC	CTAAGAAC
CTGATTCC	CGGATTCC
CGTAGTAC	CGTATACG
CTGATTAT	CGATTATT
CTGCGATC	CTGGGATC
CTACGGCC	CTAGGCCC
CTACGGCA	CACGGCAT
CTATTTCC	ATATTTCC
CGTCCGAG	CATCCGAG
CTACGGAT	GTACGGAT
CTGCGGAC	TGCGGACT
CTGTATAC	CGTATACG
CTGCGGAA	CGCGGAAG
CTGCGGAT	CTGGGATC
CGTATCCG	CGTATACG
CGTATCAC	CGTATACG
CGTATCGC	CGTATACG
CGTATCGA	CGTATACG
CGTATCGG	CGTATACG
CGTATCGT	CGTATACG
CGTATCGN	CGTATACG
CTAANAAC	CTAAGAAC
CTGCTCAG	CAGCTCAG
CTACTCTA	CTTCTCTA
CTGCTCTA	CTTCTCTA
CTAANGAA	CTAAGAAC
CTGTGATC	CTGGGATC
CGTATACC	CGTATACG
CGTATACA	CGTATACG
CGTATACG	CGTATACG
CGTATACT	CGTATACG
CGTATACN	CGTATACG
CGTATAAC	CGTATACG
CGTCAAGC	GTCAAGCC
CTGTGGAT	CTGGGATC
CTGTGGGG	TGTGGGGT
CTGTGGTT	CGGTGGTT
CGTATAAG	CGTATACG
CGTATAGC	CGTATACG
CGTATAGA	CGTATACG
CGTATAGG	CGTATACG
CGTATAGT	CGTATACG
CGTATAGN	CGTATACG
CGTATATC	CGTATACG
CGTATATG	CGTATACG
CGTATANC	CGTATACG
CGTATANG	CGTATACG
CGTCATAC	CGTATACG
CTGGCCCC	CTAGGCCC
CGTATGCG	CGTATACG
CTGGCCCA	CTAGGCCC
CTGGCCCG	CTAGGCCC
CTGGCCCT	CTAGGCCC
CGTATGAC	CGTATACG
CTGGCCCN	CTAGGCCC
CTAGCCCC	CTAGGCCC
CTAGCCCA	CTAGGCCC
CTAGCCCG	CTAGGCCC
CTAGCCCT	CTAGGCCC
CTAGCCCN	CTAGGCCC
CGTATTCC	CGGATTCC
CGTATTCG	CGTATACG
CTGGCATC	CTGGGATC
CTGGCATT	CTAGCATT
CTAGCCAT	CTAGCATT
CTGGCGCA	TGGCGCAT
CTAGCCTT	CTAGCATT
CTGGCGAT	CTGGGATC
CTANCATT	CTAGCATT
CTAGCACT	CTAGCATT
CTAGCAAT	CTAGCATT
CTGTTGAG	CCGTTGAG
CTAGCAGT	CTAGCATT
CTAGCATC	CTAGCATT
CTAGCATA	CTAGCATT
CTAGCATG	CTAGCATT
CTAGCATT	CTAGCATT
CTAGCATN	CTAGCATT
CGTCGATT	CCTCGATT
CTAGCANT	CTAGCATT
CTAGCGCC	CTAGGCCC
CGTATTAC	CGTATACG
CGTATTAT	CGATTATT
CGTCGGAA	CGCGGAAG
CTAGCGAT	CTAGCATT
CTGTTTTG	TGTTTTGA
CTAGCGTA	TAGCGTAA
CTAGCGTT	CTAGCATT
CTAGCTCA	CAGCTCAG
CGTATNCG	CGTATACG
CGTATNAC	CGTATACG
CTGGACAA	GTGGACAA
CTAGCTAT	CTAGCATT
CTAGCTTC	CTAGCATT
CTAGCTTA	CTAGCATT
CTAGCTTG	CTAGCATT
CTAGCTTT	CTAGCATT
CTAGCTTN	CTAGCATT
CTGACCCG	CGACCCGG
CTGACCAA	CTTACCAA
CTAACCCC	TTAACCCC
CTAGCNAT	CTAGCATT
CTAACCAA	CTTACCAA
CTGGAATC	CTGGGATC
CTAGCNTT	CTAGCATT
CTAACAAC	CTAAGAAC
CTAGACCC	CTAGGCCC
CTGGAGAT	CTGGGATC
CTAGACAT	CTAGCATT
CTAACATT	CTAGCATT
CGTANACG	CGTATACG
CTANAGAA	CTAAGAAC
CTGGATCC	CTGGGATC
CTGGATCA	CTGGGATC
CTGGATCG	CTGGGATC
CTGGATCT	CTGGGATC
CTGGATCN	CTGGGATC
CTAGAACC	CTAAGAAC
CTAACGAA	CTAAGAAC
CTAGAACA	CTAAGAAC
CTAGAACG	CTAAGAAC
CTAGAACT	CTAAGAAC
CTAGAACN	CTAAGAAC
CTGGATTC	CGGATTCC
CTAGAATT	CTAGCATT
CTAGAGCC	CTAGGCCC
CTAGAGAA	CTAAGAAC
CTGGGCCC	CTAGGCCC
CTGGGCAT	CTGGGATC
CGTANTAC	CGTATACG
CTGGGCTC	CTGGGATC
CTANGCCC	CTAGGCCC
CTANGCAT	CTAGCATT
CTAGATTC	CTAGCATT
CTGGGACC	CTGGGATC
CTAGATTA	CTAGCATT
CTGGGACA	CTGGGATC
CTAGATTG	CTAGCATT
CTGGGACG	CTGGGATC
CTAGATTT	CTAGCATT
CTGGGACT	CTGGGATC
CTAGATTN	CTAGCATT
CTGGGACN	CTGGGATC
CTGGGAAC	CTGGGATC
CTGGGAAT	CTGGGATC
CTGGGAGC	CTGGGATC
CTGAACTG	TGAACTGT
CTGGGAGT	CTGGGATC
CTGGGATC	CTGGGATC
CTGGGATA	CTGGGATC
CTGGGATG	CTGGGATC
CTGGGATT	CTGGGATC
CTGGGATN	CTGGGATC
CTGGGANC	CTGGGATC
CTANGAAC	CTAAGAAC
CTCGCCCC	GCTCGCCC
CTGGGANT	CTGGGATC
CTCGCCCA	GCTCGCCC
CTCGCCCG	GCTCGCCC
CTCGCCCT	GCTCGCCC
CTCGCCCN	GCTCGCCC
CTAAAACC	CTAAGAAC
CTAAAACA	CTAAGAAC
CTAAAACG	CTAAGAAC
CTAAAACT	CTAAGAAC
CTAAAACN	CTAAGAAC
CTGGGGAT	CTGGGATC
CTAAAAAC	CTAAGAAC
CTAGGCCC	CTAGGCCC
CTAGGCCA	CTAGGCCC
CTAGGCCG	CTAGGCCC
CTAGGCCT	CTAGGCCC
CTAGGCCN	CTAGGCCC
CTAGGCAC	CTAGGCCC
CTGGGGTC	CTGGGATC
CTANGGCC	CTAGGCCC
CTAGGCAT	CTAGCATT
CTAGGCGC	CTAGGCCC
CTGAAGAA	CTAAGAAC
CTAGGCTC	CTAGGCCC
CTGGGTCC	CTGGGATC
CTGGGTCA	CTGGGATC
CTGGGTCG	CTGGGATC
CTGGGTCT	CTGGGATC
CTAAAGCC	CAAAGCCA
CTGGGTCN	CTGGGATC
CTAGGCNC	CTAGGCCC
CTGGGTAT	CTGGGATC
CTAAAGAA	CTAAGAAC
CTAGGACC	CTAGGCCC
CTAAAGGA	TAAAGGAT
CTGGGTTC	CTGGGATC
CTAGGAAC	CTAAGAAC
CTCGCATT	CTAGCATT
CGTGCAAG	CCTGCAAG
CTAGGATC	CTGGGATC
CTAGGATT	CTAGCATT
CTGAATGC	CTTAATGC
CTGGGNAT	CTGGGATC
CTAGGGCC	CTAGGCCC
CTAAATGC	CTTAATGC
CTGGGNTC	CTGGGATC
CTAAATGG	CCAAATGG
CTAGGGAT	CTGGGATC
CTAGGTCC	CTAGGCCC
CTAAGCCC	CTAGGCCC
CTAAGCCA	CAAAGCCA
CTAAGCAC	CTAAGAAC
CTAAGCAA	CTAAGAAC
CTAGGNCC	CTAGGCCC
CTAAGCAT	CTAGCATT
CTGGTATC	CTGGGATC
CTAAGACC	CTAAGAAC
CTAAGACA	CTAAGAAC
CTAAGACG	CTAAGAAC
CTGGTGAT	CTGGGATC
CTAAGACT	CTAAGAAC
CTAAGACN	CTAAGAAC
CTAAGAAC	CTAAGAAC
CTAAGAAA	CTAAGAAC
CTAGTCCC	CTAGGCCC
CTAAGAAG	CTAAGAAC
CTGGTGGT	CGGTGGTT
CTAAGAAT	CTAAGAAC
CTAAGAAN	CTAAGAAC
CTAAGAGC	CTAAGAAC
CTAAGAGA	CTAAGAAC
CTAGTCAT	CTAGCATT
CTAAGATC	CTAAGAAC
CTAAGATA	CTAAGAAC
CTAAGANC	CTAAGAAC
CTAAGANA	CTAAGAAC
CTAAGGCC	CTAGGCCC
CTAAGGAC	CTAAGAAC
CTAAGGAA	CTAAGAAC
CTCTGCAA	CCTGCAAG
CTAGTATG	TAGTATGG
CTAGTATT	CTAGCATT
CTAAGTAC	CTAAGAAC
CTAGTGCC	CTAGGCCC
CTAAGTAA	CTAAGAAC
CTCTGACC	ATCTGACC
CTAAGNAC	CTAAGAAC
CTAAGNAA	CTAAGAAC
CTCGATTC	CCTCGATT
CTCGATTA	CCTCGATT
CTCGATTG	CCTCGATT
CTCGATTT	CCTCGATT
CTCGATTN	CCTCGATT
CTNACCAA	CTTACCAA
CTGGNATC	CTGGGATC
CTCTGTCG	CCCTGTCG
CTCGGCCC	CTAGGCCC
CTGNGATC	CTGGGATC
CTGGNGAT	CTGGGATC
CTCGGCAG	TTCGGCAG
CTCGGCAT	CACGGCAT
CTAGNCCC	CTAGGCCC
CTGNGGAT	CTGGGATC
CTAGNCAT	CTAGCATT
CTCGGAAG	CGCGGAAG
CTCGGATC	CTGGGATC
CTCGGGAT	CTGGGATC
CTAGNATT	CTAGCATT
CTAGNGCC	CTAGGCCC
CTTTCCCG	GTTTCCCG
CTTTCCAA	CTTACCAA
CTCTTGGA	TCTTGGAG
CTNAAGAA	CTAAGAAC
CTATCCGA	CATCCGAG
CTTTCTCT	CTTCTCTA
CTTTCTAC	CTTCTCTA
CTNAATGC	CTTAATGC
CTTTCTAA	CTTCTCTA
CTTTCTAG	CTTCTCTA
CTTTCTAT	CTTCTCTA
CTTTCTAN	CTTCTCTA
CTNTCTCT	CTTCTCTA
CTATCATT	CTAGCATT
CTCGTTGA	CCGTTGAG
CTTTACCA	CTTACCAA
CTNAGCAT	CTAGCATT
CTATCTCT	CTTCTCTA
CTNAGAAC	CTAAGAAC
CTNTACCA	CTTACCAA
CTTTAAAC	GCTTTAAA
CTTTAAAA	GCTTTAAA
CTTTAAAG	GCTTTAAA
CTTTAAAT	GCTTTAAA
CTTTAAAN	GCTTTAAA
CTTTAATG	CTTAATGC
CTNAGGCC	CTAGGCCC
CTNTAATG	CTTAATGC
CTTTATGC	CTTAATGC
CTTTGCAT	GTTTGCAT
CNCAAATG	CCAAATGG
CTCTCCGG	TCTCCGGG
CTTNTCTA	CTTCTCTA
CTTTGTGG	TTTGTGGC
CTCTCGAT	CCTCGATT
CTCTCTCT	CTTCTCTA
CTCTCTAC	CTTCTCTA
CTCTCTAA	CTTCTCTA
CTCTCTAG	CTTCTCTA
CTCTCTAT	CTTCTCTA
CTCTCTAN	CTTCTCTA
CTTTTCTA	CTTCTCTA
CTCTACCA	CTTACCAA
CTCTACAT	TTCTACAT
CNCAGTTA	CCCAGTTA
CTCTAATG	CTTAATGC
CNCATCCA	CCCATCCA
CNCCCACT	CCCCACTG
CTNGCATT	CTAGCATT
CNCCCTAA	CCCCTAAA
CNCCACTG	CCCCACTG
CTTNCCAA	CTTACCAA
CNCCAGTT	CCCAGTTA
CNCCATCC	CCCATCCA
CTTNCTCT	CTTCTCTA
CTTNACCA	CTTACCAA
CTNGGCCC	CTAGGCCC
CTTNAATG	CTTAATGC
CTNGGATC	CTGGGATC
CTTCCCAA	CTTACCAA
CTNGGGAT	CTGGGATC
CTTCCCTA	CTTCTCTA
CTTCCAAC	CTTACCAA
CTTCCAAA	CTTACCAA
CTTCCAAG	CTTACCAA
CTTCCAAT	CTTACCAA
CTTCCAAN	CTTACCAA
CTTNATGC	CTTAATGC
CTTCCGAG	CATCCGAG
CTTCCTCT	CTTCTCTA
CNCCTAAA	CCCCTAAA
CTTCCTAC	CTTCTCTA
CTTCCTAA	CTTCTCTA
CTTCCTAG	CTTCTCTA
CTTCCTAT	CTTCTCTA
CTTCCTAN	CTTCTCTA
CTTCCTGC	ATTCCTGC
CNCCTGTC	CCCTGTCG
CNGCGGAA	CGCGGAAG
CTTCACCA	CTTACCAA
CTTCACTA	CTTCTCTA
CTTAACCC	TTAACCCC
CTTAACCA	CTTACCAA
CTTAACAA	CTTACCAA
CTTAACGC	CTTAATGC
CTTAACTG	CTTAATGC
CTTCAAGG	ATTCAAGG
CTTCAATG	CTTAATGC
CTTAAAGC	CTTAATGC
CTTAAATG	CTTAATGC
CTTAAGCC	CTTAATGC
CTTAAGCA	CTTAATGC
CTTAAGCG	CTTAATGC
CTTAAGCT	CTTAATGC
CTTAAGCN	CTTAATGC
CTTAAGAA	CTAAGAAC
CTNCTCTA	CTTCTCTA
CTTCATCT	CTTCTCTA
CTTAAGGC	CTTAATGC
CTTCATGC	CTTAATGC
CTTAAGTG	CTTAATGC
CTTAATCC	CTTAATGC
CTTAATCA	CTTAATGC
CTTAATCG	CTTAATGC
CTTAATCT	CTTAATGC
CTTAATCN	CTTAATGC
CTTAATAC	CTTAATGC
CTTAATAG	CTTAATGC
CTTAATGC	CTTAATGC
CTTAATGA	CTTAATGC
CTTAATGG	CTTAATGC
CTTAATGT	CTTAATGC
CTTAATGN	CTTAATGC
CTTAATTC	CTTAATGC
CNGTTGAG	CCGTTGAG
CTTAATTG	CTTAATGC
CTTAATNC	CTTAATGC
CTTAATNG	CTTAATGC
CNGCTCAG	CAGCTCAG
CTTAANGC	CTTAATGC
CTTAANTG	CTTAATGC
CTTCGCTA	CTTCTCTA
CTTAGCCA	CTTACCAA
CTTAGCAA	CTTACCAA
CTTAGCAT	CTAGCATT
CTTCGATT	CCTCGATT
CTTCGGCA	TTCGGCAG
CTTAGAAC	CTAAGAAC
CTTAGATG	CTTAATGC
CTTAGGCC	CTAGGCCC
CTTCGTCT	CTTCTCTA
CTTAGTGC	CTTAATGC
CNGGATTC	CGGATTCC
CTTCTCCA	CTTCTCTA
CTTCTCCT	CTTCTCTA
CTTCTCAC	CTTCTCTA
CTTCTCAA	CTTCTCTA
CTTCTCAG	CTTCTCTA
CTTCTCAT	CTTCTCTA
CTTCTCAN	CTTCTCTA
CTTCTCGA	CTTCTCTA
CTTCTCGT	CTTCTCTA
CTTCTCTC	CTTCTCTA
CTTCTCTA	CTTCTCTA
CTTCTCTG	CTTCTCTA
CTTCTCTT	CTTCTCTA
CTTCTCTN	CTTCTCTA
CTTCTCNA	CTTCTCTA
CTTCTCNT	CTTCTCTA
CTTCTACA	TTCTACAT
CTTCTACT	CTTCTCTA
CTTATCCA	CTTACCAA
CTTATCAA	CTTACCAA
CTTCTATA	CTTCTCTA
CTTATCTA	CTTCTCTA
CTTCTGCT	CTTCTCTA
CTTATACG	CGTATACG
CTTCTGTA	CTTCTCTA
CNGGGATC	CTGGGATC
CTTATATG	CTTAATGC
CTTCTTCT	CTTCTCTA
CTTCTTAC	CTTCTCTA
CTTCTTAA	CTTCTCTA
CTTCTTAG	CTTCTCTA
CTTATGCC	CTTAATGC
CTTCTTAT	CTTCTCTA
CTTCTTAN	CTTCTCTA
CTTATGCA	CTTAATGC
CTTATGCG	CTTAATGC
CTTATGCT	CTTAATGC
CTTATGCN	CTTAATGC
CTTCTTTA	CTTCTCTA
CNAAAGCC	CAAAGCCA
CTTCTNCT	CTTCTCTA
CTTCTNTA	CTTCTCTA
CTTATTGC	CTTAATGC
CNAAATGG	CCAAATGG
CTTCNCTA	CTTCTCTA
CNGACCCG	CGACCCGG
CTTANCCA	CTTACCAA
CNAAGCCA	CAAAGCCA
CTTANCAA	CTTACCAA
CNAAGAAC	CTAAGAAC
CNAGGCCC	CTAGGCCC
CTTCNTCT	CTTCTCTA
CTTANATG	CTTAATGC
CNGGTGGT	CGGTGGTT
CTTACCCA	CTTACCAA
CTTACCAC	CTTACCAA
CTTACCAA	CTTACCAA
CTTACCAG	CTTACCAA
CTTACCAT	CTTACCAA
CTTACCAN	CTTACCAA
CTTANTGC	CTTAATGC
CTTACCGA	CTTACCAA
CTTACCTA	CTTACCAA
CTTACCNA	CTTACCAA
CTTACACA	CTTACCAA
CTTACAAC	CTTACCAA
CTTACAAA	CTTACCAA
CTTACAAG	CTTACCAA
CTTACAAT	CTTACCAA
CTTACAAN	CTTACCAA
CTTACATG	CTTAATGC
CTTACGCA	CTTACCAA
CTTACGAA	CTTACCAA
CTTGCCAA	CTTACCAA
CTTACTCA	CTTACCAA
CTTACTCT	CTTCTCTA
CTTACTAA	CTTACCAA
CTTGCACG	TTGCACGA
CTTACTGC	CTTAATGC
CTTGCAAG	CCTGCAAG
CTTGCATT	CTAGCATT
CTTACNCA	CTTACCAA
CTTACNAA	CTTACCAA
CNCGGCAT	CACGGCAT
CTTGCTCT	CTTCTCTA
CNCGGAAG	CGCGGAAG
CTTGACCA	CTTACCAA
CTTGAATG	CTTAATGC
CTTGAGTT	TTGAGTTA
CTTGATGC	CTTAATGC
CTTGGCCC	CTAGGCCC
CNAGCATT	CTAGCATT
CNCGTTGA	CCGTTGAG
CNATCCGA	CATCCGAG
CNGTATAC	CGTATACG
CNAGCTCA	CAGCTCAG
CTTGGAGC	TCTTGGAG
CTTGGAGA	TCTTGGAG
CTTGGAGG	TCTTGGAG
CTTGGAGT	TCTTGGAG
CTTGGAGN	TCTTGGAG
CTTGGATC	CTGGGATC
CNGATTCC	CGGATTCC
CTTGGGAT	CTGGGATC
CNGATTAT	CGATTATT
CNGTGGTT	CGGTGGTT
CNTCCGAG	CATCCGAG
CTTGTCTA	CTTCTCTA
CTTGTAAG	TTGTAAGC
CTTGTGGC	TTTGTGGC
CNCTCGAT	CCTCGATT
ACCAGGTA	ACCGGTAA
ACCAGTAA	ACCGGTAA
ACCAGTTA	CCCAGTTA
ACCATCCA	CCCATCCA
ACCCCACT	CCCCACTG
ACCATCGT	ACATCGTT
ACCCCGCG	AACCCGCG
ACCCCTAA	CCCCTAAA
ACCCCTGG	ACCCTTGG
ACCCCTTG	ACCCTTGG
ACCCCTTT	GCCCCTTT
ACCATTAG	ACAATTAG
ACCATTGG	ACCCTTGG
CNATTATT	CGATTATT
CNCTGCAA	CCTGCAAG
ACCCACTG	CCCCACTG
ACCCAGTT	CCCAGTTA
CNCTGTCG	CCCTGTCG
ACCCATCC	CCCATCCA
ACCCATGG	ACCCTTGG
ACCCATTG	ACCCTTGG
ACCCGCGC	AACCCGCG
ACCCGCGA	AACCCGCG
ACCCGCGG	AACCCGCG
ACCCGCGT	AACCCGCG
ACCCGCGN	AACCCGCG
ACCCGGTA	ACCGGTAA
ACCCGTAA	ACCGGTAA
ACCCGTGG	ACCCTTGG
ACCGCGTA	ACCGGTAA
ACCCGTTG	ACCCTTGG
ACCGCTCC	ACGCTCCT
ACCGCTAA	ACCGGTAA
ACCGCTAG	TCCGCTAG
ACCGCTTG	ACCCTTGG
ACCCTCCT	ACGCTCCT
ACCCTCGG	ACCCTTGG
ACCCTCTG	ACCCTTGG
ACCCTAAA	CCCCTAAA
ACCCTAGG	ACCCTTGG
ACCCTATG	ACCCTTGG
ACCCTGGC	ACCCTTGG
ACCCTGGA	ACCCTTGG
ACCCTGGG	ACCCTTGG
ACCCTGGT	ACCCTTGG
ACCCTGGN	ACCCTTGG
ACCCTGTC	CCCTGTCG
ACCCTGTG	ACCCTTGG
ACCCTTCG	ACCCTTGG
ACCCTTAG	ACCCTTGG
ACCCTTGC	ACCCTTGG
ACCCTTGA	ACCCTTGG
ACCCTTGG	ACCCTTGG
ACCCTTGT	ACCCTTGG
ACCCTTGN	ACCCTTGG
ACCCTTTG	ACCCTTGG
ACCCTTNG	ACCCTTGG
ACCGAGTA	ACCGGTAA
ACCCTNGG	ACCCTTGG
ACCCTNTG	ACCCTTGG
ACCGATAA	ACCGGTAA
ACCGGCAA	ACCGGTAA
ACCGGCTA	ACCGGTAA
ACCGGAAC	ACCGGTAA
ACCGGAAA	ACCGGTAA
ACCGGAAG	ACCGGTAA
ACCGGAAT	ACCGGTAA
ACCGGAAN	ACCGGTAA
ACCCNTGG	ACCCTTGG
ACCGGATA	ACCGGTAA
ACCCNTTG	ACCCTTGG
CNACCCGG	CGACCCGG
ACCGGGAA	ACCGGTAA
ACCGGGTC	GCCGGGTC
ACCGGGTA	ACCGGTAA
ACCGGTCA	ACCGGTAA
ACCACCAC	TACCACCA
ACCACCAA	TACCACCA
ACCACCAG	TACCACCA
ACCACCAT	TACCACCA
ACCGGTAC	ACCGGTAA
ACCACCAN	TACCACCA
ACCGGTAA	ACCGGTAA
ACCGGTAG	ACCGGTAA
ACCGGTAT	ACCGGTAA
ACCGGTAN	ACCGGTAA
ACCGGTGA	ACCGGTAA
ACCGGTTA	ACCGGTAA
ACCGGTNA	ACCGGTAA
CNTCGATT	CCTCGATT
ACCGGNAA	ACCGGTAA
ACCGGNTA	ACCGGTAA
ACCACGCG	ACAACGCG
ACCACTTG	ACCCTTGG
ACCGTAAC	ACCGGTAA
ACCGTAAA	ACCGGTAA
ACCGTAAG	ACCGGTAA
ACCGTAAT	ACCGGTAA
ACCGTAAN	ACCGGTAA
ACAAACGC	ACAACGCG
CNTCTCTA	CTTCTCTA
ACCGTGTA	ACCGGTAA
ACCAACGC	ACAACGCG
ACCAACGA	TCCAACGA
ACAAAGCC	CAAAGCCA
ACAAAGCG	ACAACGCG
ACCGTTAA	ACCGGTAA
ACCGTTGA	CCGTTGAG
ACCGTTGG	ACCCTTGG
ACCGTTTC	AGCGTTTC
ACAAAGTA	GCAAAGTA
ACCAAATG	CCAAATGG
ACAAATAG	ACAATTAG
ACAAATGG	CCAAATGG
ACAAATTA	ACAATTAG
ACCAATTA	ACAATTAG
ACAAGCGC	ACAACGCG
ACAAGCGA	ACAACGCG
ACAAGCGG	ACAACGCG
ACAAGCGT	ACAACGCG
ACAAGCGN	ACAACGCG
CNACGGCA	CACGGCAT
ACGGTCCT	ACGCTCCT
ACGGTCGG	AGGGTCGG
ACCGNGTA	ACCGGTAA
ACAAGGCG	ACAACGCG
ACANTCGT	ACATCGTT
ACGGTAAC	ACCGGTAA
ACGGTAAA	ACCGGTAA
ACGGTAAG	ACCGGTAA
ACGGTAAT	ACCGGTAA
ACGGTAAN	ACCGGTAA
ACCGNTAA	ACCGGTAA
ACAAGTAG	ACAATTAG
ACGGTGGT	CGGTGGTT
ACAAGTTA	ACAATTAG
ACANTTAG	ACAATTAG
ACAATCAG	ACAATTAG
ACAATCGC	ACAACGCG
ACAATCGT	ACATCGTT
ACAATCTA	ACAATTAG
CNTACCAA	CTTACCAA
ACAATAAG	ACAATTAG
ACAATAGC	ACAATTAG
ACAATAGA	ACAATTAG
ACAATAGG	ACAATTAG
ACAATAGT	ACAATTAG
ACAATAGN	ACAATTAG
ACAATATA	ACAATTAG
ACAATGCG	ACAACGCG
ACAATGAG	ACAATTAG
ACAATGTA	ACAATTAG
ACAATTCA	ACAATTAG
ACAATTCG	ACAATTAG
ACAATTAC	ACAATTAG
ACAATTAA	ACAATTAG
ACAATTAG	ACAATTAG
ACAATTAT	ACAATTAG
ACAATTAN	ACAATTAG
ACAATTGC	ACAATTAG
ACAATTGA	ACAATTAG
ACAATTGG	ACAATTAG
ACAATTGT	ACAATTAG
ACAATTGN	ACAATTAG
ACGACCCG	CGACCCGG
ACAATTTA	ACAATTAG
ACAATTTG	ACAATTAG
ACAATTNA	ACAATTAG
ACAATTNG	ACAATTAG
ACAATNAG	ACAATTAG
ACAATNTA	ACAATTAG
CNTGCAAG	CCTGCAAG
ACAANCGC	ACAACGCG
ACGACGCG	ACAACGCG
ACGACTCC	ACGCTCCT
ACGTCCTC	ACGCTCCT
ACGCCCCT	ACGCTCCT
ACGTCCTA	ACGCTCCT
ACGTCCTG	ACGCTCCT
ACGTCCTT	ACGCTCCT
ACGTCCTN	ACGCTCCT
ACAANGCG	ACAACGCG
ACGCCCTC	ACGCTCCT
ACGCCCTA	ACGCTCCT
ACGCCCTG	ACGCTCCT
ACGCCCTT	ACGCTCCT
ACGCCCTN	ACGCTCCT
CNTAAGAA	CTAAGAAC
ACAANTAG	ACAATTAG
CNTAATGC	CTTAATGC
ACGTCGTA	ATGTCGTA
ACAANTTA	ACAATTAG
ACGTCGTT	ACATCGTT
ACGAACGC	ACAACGCG
ACGTCTCC	ACGCTCCT
ACGCCTCC	ACGCTCCT
ACGAAATC	AAGAAATC
ACGCCTTG	ACCCTTGG
CNTAGCAT	CTAGCATT
ACGNTCCT	ACGCTCCT
ACAGCAGG	AAGCAGGC
ACGCACCT	ACGCTCCT
ACAGCGCG	ACAACGCG
CNTAGGCC	CTAGGCCC
ACAGCGTT	ACATCGTT
ACGAATTA	ACAATTAG
ACAGCTCC	ACGCTCCT
ACAGCTCA	CAGCTCAG
ACGTAGGT	GCGTAGGT
ACGCAGGC	AAGCAGGC
ACATCCGA	CATCCGAG
ACATCCGT	ACATCGTT
ACGTATAC	CGTATACG
ACATCCTT	ACATCGTT
ACGCATCC	ACGCTCCT
ACATCAGT	ACATCGTT
CNTGGGAT	CTGGGATC
ACATCATT	ACATCGTT
ACAGACGC	ACAACGCG
ACATCGCG	ACAACGCG
ACATCGCT	ACATCGTT
ACATCGAT	ACATCGTT
ACATCGGT	ACATCGTT
ACATCGTC	ACATCGTT
ACATCGTA	ACATCGTT
CNTATACG	CGTATACG
ACATCGTG	ACATCGTT
ACATCGTT	ACATCGTT
ACAGAAAC	TCAGAAAC
ACATCGTN	ACATCGTT
ACAGAAAT	AAGAAATC
ACATCGNT	ACATCGTT
ACGCGCCT	ACGCTCCT
ACATCTGT	ACATCGTT
ACATCTTC	ACATCGTT
ACATCTTA	ACATCGTT
ACATCTTG	ACATCGTT
ACATCTTT	ACATCGTT
ACATCTTN	ACATCGTT
ACATCNGT	ACATCGTT
ACATCNTT	ACATCGTT
ACGCGGAA	CGCGGAAG
ACAGATTA	ACAATTAG
ACATACGC	ACAACGCG
ACATACGT	ACATCGTT
ACGCGGTA	ACCGGTAA
ACGCGTCC	ACGCTCCT
ACATAACT	ATATAACT
ACGATCCT	ACGCTCCT
ACGCGTTT	AGCGTTTC
ACGATCGT	ACATCGTT
ACCTCCTC	ACGCTCCT
ACCTCCTA	ACGCTCCT
ACCTCCTG	ACGCTCCT
ACCTCCTT	ACGCTCCT
ACCTCCTN	ACGCTCCT
ACATAGTT	ACATCGTT
ACGCTCCC	ACGCTCCT
ACGCTCCA	ACGCTCCT
ACGCTCCG	ACGCTCCT
ACGCTCCT	ACGCTCCT
ACGCTCCN	ACGCTCCT
ACGCTCAC	ACGCTCCT
ACGCTCAT	ACGCTCCT
ACGCTCGC	ACGCTCCT
ACGCTCGT	ACGCTCCT
ACGCTCTC	ACGCTCCT
ACGCTCTA	ACGCTCCT
ACGCTCTG	ACGCTCCT
ACGCTCTT	ACGCTCCT
ACATATTA	ACAATTAG
ACGCTCTN	ACGCTCCT
ACGCTCNC	ACGCTCCT
ACAGGGAG	AAGGGAGT
ACGCTCNT	ACGCTCCT
ACGCTACC	ACGCTCCT
ACCTCGAT	CCTCGATT
ACGCTACT	ACGCTCCT
ACCTCGTT	ACATCGTT
ACAGGTCT	TCAGGTCT
ACAGGTAA	ACCGGTAA
ACGCTGCC	ACGCTCCT
ACGCTGCT	ACGCTCCT
ACGTTCCT	ACGCTCCT
ACGATTAG	ACAATTAG
ACGATTAT	CGATTATT
ACCTCTTG	ACCCTTGG
ACATGCGT	ACATCGTT
ACGCTTCC	ACGCTCCT
ACGCTTCT	ACGCTCCT
ACGCTTGG	ACCCTTGG
ACGCTNCC	ACGCTCCT
ACGTTGCC	AAGTTGCC
ACGCTNCT	ACGCTCCT
ACAGTCGT	ACATCGTT
ACGTTGAG	CCGTTGAG
ACATGGTC	AATGGTCA
ACATGGTT	ACATCGTT
ACGTTTCC	AGCGTTTC
ACGTTTCA	AGCGTTTC
ACGCNCCT	ACGCTCCT
ACGTTTCG	AGCGTTTC
ACGTTTCT	AGCGTTTC
ACGTTTCN	AGCGTTTC
ACATGTTC	ACATCGTT
ACATGTTA	ACATCGTT
ACATGTTG	ACATCGTT
ACATGTTT	ACATCGTT
ACATGTTN	ACATCGTT
ACAGTTAG	ACAATTAG
ACAGTTGC	AAGTTGCC
ACATTCGT	ACATCGTT
ACGCNTCC	ACGCTCCT
ACATTAGC	ACAATTAG
ACATTAGA	ACAATTAG
ACATTAGG	ACAATTAG
ACATTAGT	ACAATTAG
ACATTAGN	ACAATTAG
ACCTGCAA	CCTGCAAG
ACATTGTT	ACATCGTT
ACCTGACC	ATCTGACC
ACATTTCC	ATATTTCC
ACGGCCAA	AGGGCCAA
ACTCCGGG	TCTCCGGG
ACATTTAG	ACAATTAG
ACTCCTGC	ATTCCTGC
ACTCCTTG	ACCCTTGG
ACGGCATC	CACGGCAT
ACGGCATA	CACGGCAT
ACGGCATG	CACGGCAT
ACGGCATT	CACGGCAT
ACCTGGTA	ACCGGTAA
ACGGCATN	CACGGCAT
ACCTGTCG	CCCTGTCG
ACCTGTAA	ACCGGTAA
ACATNCGT	ACATCGTT
ACGGCTCC	ACGCTCCT
ACTCAAGG	ATTCAAGG
ACCTTCAC	TCCTTCAC
ACATNGTT	ACATCGTT
ACGNCTCC	ACGCTCCT
CNTTCTCT	CTTCTCTA
ACCTTAGT	GCCTTAGT
ACCTTGGC	ACCCTTGG
ACCTTGGA	ACCCTTGG
ACCTTGGG	ACCCTTGG
ACCTTGGT	ACCCTTGG
ACCTTGGN	ACCCTTGG
ACCTTGTA	AACTTGTA
CNTTACCA	CTTACCAA
AACCGCGC	AACCCGCG
AACCGCGA	AACCCGCG
AACCGCGG	AACCCGCG
AACCGCGT	AACCCGCG
AACCGCGN	AACCCGCG
ACCTTTGG	ACCCTTGG
ACTCGCCC	GCTCGCCC
ACNGGTAA	ACCGGTAA
CNTTAATG	CTTAATGC
AACCGGCG	AACCCGCG
ACGGATTC	CGGATTCC
ACANCGCG	ACAACGCG
ACTCGATT	CCTCGATT
AACCGGTA	ACCGGTAA
ACANCGTT	ACATCGTT
ACTCGGTA	ACCGGTAA
ACGGGCCA	AGGGCCAA
ACTCGTTC	ACATCGTT
ACTCGTTA	ACATCGTT
ACTCGTTG	ACATCGTT
ACTCGTTT	ACATCGTT
ACTCGTTN	ACATCGTT
AACCTCGC	AACCCGCG
ACGGGAGT	AAGGGAGT
ACANACGC	ACAACGCG
ACTCTCCT	ACGCTCCT
AACCTGCG	AACCCGCG
ACGGGTCG	AGGGTCGG
ACGGGTAA	ACCGGTAA
AACCTGTA	AACTTGTA
ACTCTGAC	ATCTGACC
ACCNTTGG	ACCCTTGG
AACCTTGG	ACCCTTGG
AACCTTGT	AACTTGTA
AACCTTTC	AAACCTTT
AACCTTTA	AAACCTTT
AACCTTTG	AAACCTTT
AACCTTTT	AAACCTTT
AACCTTTN	AAACCTTT
ACANATTA	ACAATTAG
ACTCTTGG	ACCCTTGG
AACCNCGC	AACCCGCG
ACNCTCCT	ACGCTCCT
AACGCCGC	AACCCGCG
ACCNCTTG	ACCCTTGG
AACCNGCG	AACCCGCG
AACGCAGG	AAGCAGGC
AACGCGCG	AACCCGCG
AACGCTCC	ACGCTCCT
ACNCTTGG	ACCCTTGG
ACACCCGC	AACCCGCG
AACACCGC	AACCCGCG
AACACCTT	AAACCTTT
ACNTCGTT	ACATCGTT
AACACAAG	AAACAAGT
AACGAAAT	AAGAAATC
ACACCGCG	ACAACGCG
AACACGCG	AACCCGCG
ACACCGTT	ACATCGTT
ACACCTTG	ACCCTTGG
ACACCTTT	AAACCTTT
ACCNGGTA	ACCGGTAA
AACAACGC	ACAACGCG
ACACACGC	ACAACGCG
ACNCCTTG	ACCCTTGG
AACGGCAT	CACGGCAT
ACCNGTAA	ACCGGTAA
ACACAAGT	AAACAAGT
AACAAATC	AAGAAATC
AACGGAGT	AAGGGAGT
ACNACGCG	ACAACGCG
AACAAGTC	AAACAAGT
AACAAGTA	AAACAAGT
AACAAGTG	AAACAAGT
AACAAGTT	AAACAAGT
AACAAGTN	AAACAAGT
AACGGGAG	AAGGGAGT
AACAATTA	ACAATTAG
ACACATTA	ACAATTAG
AACGGTCA	AATGGTCA
AACGGTAA	ACCGGTAA
ACACGCGC	ACAACGCG
ACACGCGA	ACAACGCG
ACACGCGG	ACAACGCG
ACACGCGT	ACAACGCG
ACACGCGN	ACAACGCG
ACNAACGC	ACAACGCG
AACAGGCC	AAGCAGGC
AACAGGCA	AAGCAGGC
AACAGGCG	AAGCAGGC
AACAGGCT	AAGCAGGC
AACAGGCN	AAGCAGGC
ACACGGCA	CACGGCAT
ACACGGTA	ACCGGTAA
AACGTGTA	AACTTGTA
ACACGTTC	ACATCGTT
ACACGTTA	ACATCGTT
ACACGTTG	ACATCGTT
ACACGTTT	ACATCGTT
ACACGTTN	ACATCGTT
AACGTTGC	AAGTTGCC
ACNAATTA	ACAATTAG
AACGTTGT	AACTTGTA
AACGTTTC	AGCGTTTC
ACNCGGTA	ACCGGTAA
ACTACGCG	ACAACGCG
ACACTCCT	ACGCTCCT
AACATCGT	ACATCGTT
ACACTCGT	ACATCGTT
AACATGTA	AACTTGTA
ACACTTCT	GCACTTCT
AACATTGT	AACTTGTA
ACTAACGC	ACAACGCG
ACACTTAG	ACAATTAG
AAGCCCGC	AACCCGCG
ACTAACTC	GACTAACT
ACTAACTA	GACTAACT
ACACTTGG	ACCCTTGG
ACTAACTG	GACTAACT
ACACTTGT	AACTTGTA
ACTAACTT	GACTAACT
ACTAACTN	GACTAACT
AAGCCAGG	AAGCAGGC
AAGCCGCG	AACCCGCG
ACTAAGAA	CTAAGAAC
AAGCCGGC	AAGCAGGC
AACTCCGC	AACCCGCG
ACNATCGT	ACATCGTT
ACTAATTA	ACAATTAG
AAGCCTTT	AAACCTTT
AAAGCCAC	CAAAGCCA
AAAGCCAA	CAAAGCCA
AAAGCCAG	CAAAGCCA
AAAGCCAT	CAAAGCCA
AAAGCCAN	CAAAGCCA
AAAGCCTT	AAACCTTT
AACTCGCG	AACCCGCG
AAAGCAAG	AAACAAGT
AACTCGTA	AACTTGTA
AAAGCAGG	AAGCAGGC
ACTAGCAT	CTAGCATT
AAGCACGC	AAGCAGGC
AAGCACGG	AAGCAGGC
ACNATTAG	ACAATTAG
AACTCTGT	AACTTGTA
AAGCAAAT	AAGAAATC
AAGCAAGC	AAGCAGGC
AAGCAAGG	AAGCAGGC
AAGCAAGT	AAACAAGT
AAGCAATC	AAGAAATC
ACTAGGCC	CTAGGCCC
AAGCAGCC	AAGCAGGC
AAGCAGCA	AAGCAGGC
AAGCAGCG	AAGCAGGC
AAGCAGCT	AAGCAGGC
AAGCAGCN	AAGCAGGC
AAGCAGAC	AAGCAGGC
AAAGCTTT	AAACCTTT
AAGCAGAG	AAGCAGGC
AAGCAGGC	AAGCAGGC
AAGCAGGA	AAGCAGGC
AAGCAGGG	AAGCAGGC
AAGCAGGT	AAGCAGGC
AAGCAGGN	AAGCAGGC
AAGCAGTC	AAGCAGGC
AAGCAGTG	AAGCAGGC
AAGCAGNC	AAGCAGGC
AAGCAGNG	AAGCAGGC
AAGTAAAT	AAGAAATC
AAGTAATC	AAGAAATC
AAGCATGC	AAGCAGGC
AACTAACT	GACTAACT
AAGCATGG	AAGCAGGC
AAGTAGCC	AAGTTGCC
AAGTAGGC	AAGCAGGC
ACAACCCG	ACAACGCG
ACAACCGC	ACAACGCG
ACAACCGA	ACAACGCG
AAGCANGC	AAGCAGGC
ACAACCGG	ACAACGCG
ACAACCGT	ACAACGCG
AAGCANGG	AAGCAGGC
ACAACCGN	ACAACGCG
ACAACCTT	AAACCTTT
AAAGAAAT	AAGAAATC
AACTAGTA	AACTTGTA
AAGTATGC	AAGTTGCC
AAGTATGG	TAGTATGG
ACAACACG	ACAACGCG
AAAGAAGT	AAACAAGT
ACAACAAG	AAACAAGT
ACAACAGC	ACAACGCG
AACTATGT	AACTTGTA
ACTATCGT	ACATCGTT
ACAACGCC	ACAACGCG
ACAACGCA	ACAACGCG
ACAACGCG	ACAACGCG
ACAACGCT	ACAACGCG
ACAACGCN	ACAACGCG
ACAACGAC	ACAACGCG
ACAACGAG	ACAACGCG
ACAACGGC	ACAACGCG
ACAACGGA	ACAACGCG
ACAACGGG	ACAACGCG
AAGCGAGG	AAGCAGGC
ACAACGGT	ACAACGCG
AAGCGAGT	AAGGGAGT
ACAACGGN	ACAACGCG
ACAACGTC	ACAACGCG
AAGTGCCC	AAGTTGCC
AAGTGCCA	AAGTTGCC
ACAACGTG	ACAACGCG
AAGTGCCG	AAGTTGCC
ACTATAAC	ATATAACT
AAGTGCCT	AAGTTGCC
ACAACGTT	ACATCGTT
AAGTGCCN	AAGTTGCC
ACAACGNC	ACAACGCG
ACAACGNG	ACAACGCG
AAGCGGCC	AAGCAGGC
AAGCGGCA	AAGCAGGC
AAGCGGCG	AAGCAGGC
AAGCGGCT	AAGCAGGC
AAGCGGCN	AAGCAGGC
ACAACTCG	ACAACGCG
AAGCGGAG	AAGGGAGT
AAGCGGGC	AAGCAGGC
ACAACTAG	ACAATTAG
ACAACTGC	ACAACGCG
ACAACTTA	ACAATTAG
ACAACNCG	ACAACGCG
AAGTGAGT	AAGGGAGT
AAGCGTAA	TAGCGTAA
AACTGACC	ATCTGACC
ACAACNGC	ACAACGCG
AAGTGGCC	AAGTTGCC
AAGCGTTT	AGCGTTTC
AAGTGGAG	AAGGGAGT
ACTATTAG	ACAATTAG
AAGTGGTC	AATGGTCA
ACTATTTC	ATATTTCC
AACTGGTC	AATGGTCA
AACTGGTA	AACTTGTA
AAGTGTGC	AAGTTGCC
AAGCTCCT	ACGCTCCT
AAAGGAGT	AAGGGAGT
AAGTGTTC	GAGTGTTC
AAGCTCAG	CAGCTCAG
AAAGGATC	TAAAGGAT
AACCCCCG	AACCCGCG
AAAGGATA	TAAAGGAT
AAAGGATG	TAAAGGAT
ACNGCTCC	ACGCTCCT
AAAGGATT	TAAAGGAT
AAAGGATN	TAAAGGAT
AACTGTAC	AACTTGTA
AACTGTAA	AACTTGTA
AACCCCGC	AACCCGCG
AACTGTAG	AACTTGTA
AACCCCGA	AACCCGCG
AACTGTAT	AACTTGTA
AACCCCGG	AACCCGCG
AACTGTAN	AACTTGTA
AACCCCGT	AACCCGCG
AACCCCGN	AACCCGCG
AACTGTGT	AACTTGTA
AAAGGGAG	AAGGGAGT
ACTGGGAT	CTGGGATC
AACCCACG	AACCCGCG
AAGCTAGG	AAGCAGGC
AAGTTCCC	AAGTTGCC
AAGTTCCA	AAGTTGCC
AAGTTCCG	AAGTTGCC
ACTGGTCA	AATGGTCA
AAAGGTCA	AATGGTCA
AAGTTCCT	AAGTTGCC
AAGTTCCN	AAGTTGCC
ACTGGTAA	ACCGGTAA
AAGCTGCC	AAGTTGCC
AAGTTCGC	AAGTTGCC
AACCCAGC	AACCCGCG
AAGCTGGC	AAGCAGGC
AAGTTACC	AAGTTGCC
AACCCGCC	AACCCGCG
AACCCGCA	AACCCGCG
AACCCGCG	AACCCGCG
AAGTTAGC	AAGTTGCC
AACCCGCT	AACCCGCG
AACCCGCN	AACCCGCG
AACCCGAC	AACCCGCG
AAGCTTGC	AAGTTGCC
AACCCGAG	AACCCGCG
AAGCTTGT	AACTTGTA
AACCCGGC	AACCCGCG
AAGTTGCC	AAGTTGCC
AACCCGGA	AACCCGCG
AAGTTGCA	AAGTTGCC
AACCCGGG	AACCCGCG
AAGTTGCG	AAGTTGCC
AACCCGGT	AACCCGCG
AAGTTGCT	AAGTTGCC
AACCCGGN	AACCCGCG
AAGTTGCN	AAGTTGCC
AACCCGTC	AACCCGCG
AAGTTGAC	AAGTTGCC
AACCCGTG	AACCCGCG
AACCCGNC	AACCCGCG
AAGTTGGC	AAGTTGCC
ACTGTCGT	ATGTCGTA
AACCCGNG	AACCCGCG
AAGTTGTC	AAGTTGCC
AAGTTGTA	AACTTGTA
AACCCTCG	AACCCGCG
AAGTTGNC	AAGTTGCC
AACCCTGC	AACCCGCG
AAGTTTCC	AAGTTGCC
AACCCTTG	ACCCTTGG
AACCCTTT	AAACCTTT
AAATGGTC	AATGGTCA
AAGTTTGC	AAGTTGCC
AACCCNCG	AACCCGCG
AAGTTNCC	AAGTTGCC
AACCCNGC	AACCCGCG
AAGTTNGC	AAGTTGCC
AACCACCA	TACCACCA
AAGCNAGG	AAGCAGGC
AACCACGC	AACCCGCG
AAAGTTGC	AAGTTGCC
AAGCNGGC	AAGCAGGC
AATCCCGC	AACCCGCG
AACCAAGT	AAACAAGT
AACCAGCG	AACCCGCG
ACTGCAAG	CCTGCAAG
AAGTNGCC	AAGTTGCC
AACCAGGC	AAGCAGGC
AAATTAGC	ACAATTAG
AAATTAGA	ACAATTAG
AAATTAGG	ACAATTAG
AAATTAGT	ACAATTAG
AAATTAGN	ACAATTAG
AATCCGCG	AACCCGCG
AAATTGCC	AAGTTGCC
AATCCGAG	CATCCGAG
AAGTNTGC	AAGTTGCC
AAATTGTA	AACTTGTA
AATCCTCC	GAATCCTC
AATCCTCA	GAATCCTC
AATCCTCG	GAATCCTC
AAATTTCC	ATATTTCC
AATCCTCT	GAATCCTC
AATCCTCN	GAATCCTC
ACTGCTCC	ACGCTCCT
AAGACCTT	AAACCTTT
AATCCTGC	ATTCCTGC
AATCCTTT	AAACCTTT
AAGACAAG	AAACAAGT
AAGACAAT	AAGAAATC
AAGACAGG	AAGCAGGC
AAGACATC	AAGAAATC
AAGATAAT	AAGAAATC
ACTGACCC	ATCTGACC
ACTGACCA	ATCTGACC
ACTGACCG	ATCTGACC
ACTGACCT	ATCTGACC
AAGATATC	AAGAAATC
ACTGACCN	ATCTGACC
AAGNCAGG	AAGCAGGC
AAGATGCC	AAGTTGCC
AATCAAGG	ATTCAAGG
AATCAAGT	AAACAAGT
ACTTCCTG	ATTCCTGC
AAATCCTC	GAATCCTC
AAATCCTT	AAACCTTT
AATCAGGC	AAGCAGGC
AAGATTGC	AAGTTGCC
ACTTCAAG	ATTCAAGG
AAATCAAG	AAACAAGT
AAGAACAT	AAGAAATC
AAGAACTC	AAGAAATC
AAGAAACC	AAGAAATC
AAGAAACA	AAGAAATC
AAGAAACG	AAGAAATC
AAATCGAG	TAATCGAG
AAGAAACT	AAGAAATC
AAGAAACN	AAGAAATC
AAGAAAAC	AAGAAATC
AAGAAAAT	AAGAAATC
AAGAAAGC	AAGAAATC
ACTTCGTT	ACATCGTT
AAGAAAGT	AAGAAATC
AAATCGTT	ACATCGTT
AAGAAATC	AAGAAATC
AAGAAATA	AAGAAATC
AAGAAATG	AAGAAATC
AAGAAATT	AAGAAATC
AAGAAATN	AAGAAATC
AAGAAANC	AAGAAATC
ACTTCTCT	CTTCTCTA
AAGAAANT	AAGAAATC
AAGAAGAT	AAGAAATC
AAGAAGGC	AAGCAGGC
AAGAAGGG	GAGAAGGG
AAATCTTT	AAACCTTT
AAGAAGTC	AAGAAATC
AAGANAAT	AAGAAATC
AAGAATCC	AAGAAATC
AAGNAAAT	AAGAAATC
AAGAATCA	AAGAAATC
AAGAATCG	AAGAAATC
AAGANATC	AAGAAATC
AAGAATCT	AAGAAATC
AAGAATCN	AAGAAATC
AAANCCTT	AAACCTTT
AAGNAATC	AAGAAATC
AAGAATAT	AAGAAATC
AAGAATTC	AAGAAATC
ACTTACCA	CTTACCAA
AATCGAGC	TAATCGAG
AATCGAGA	TAATCGAG
AATCGAGG	TAATCGAG
AAANCAAG	AAACAAGT
AATCGAGT	TAATCGAG
AATCGAGN	TAATCGAG
AATCGATA	GATCGATA
AAGNAGGC	AAGCAGGC
AACTTCGT	AACTTGTA
AAGAANAT	AAGAAATC
AACTTCTA	AACTTGTA
AAGAANTC	AAGAAATC
AATCGGTC	AATGGTCA
AAATAACT	ATATAACT
AAGAGCCG	GAGAGCCG
AATCGTCA	AATGGTCA
AAATAAGT	AAACAAGT
ACTTAATG	CTTAATGC
AACTTAGT	AACTTGTA
AACTTATA	AACTTGTA
AATCGTTC	ACATCGTT
AATCGTTA	ACATCGTT
AACTTGCC	AAGTTGCC
AATCGTTG	ACATCGTT
AATCGTTT	ACATCGTT
AACTTGCA	AACTTGTA
AATCGTTN	ACATCGTT
AACTTGCT	AACTTGTA
AACTTGAC	AACTTGTA
AAGAGAAT	AAGAAATC
AAANCTTT	AAACCTTT
AACTTGAA	AACTTGTA
AACTTGAG	AACTTGTA
AACTTGAT	AACTTGTA
AACTTGAN	AACTTGTA
AAGAGAGT	AAGGGAGT
AACTTGGA	AACTTGTA
AAGAGATC	AAGAAATC
AACTTGGT	AACTTGTA
AACTTGTC	AACTTGTA
AAGGCCAA	AGGGCCAA
AACTTGTA	AACTTGTA
AACTTGTG	AACTTGTA
AACTTGTT	AACTTGTA
AACTTGTN	AACTTGTA
AAGAGGCC	AAGCAGGC
AACTTGNA	AACTTGTA
AAGAGGCA	AAGCAGGC
AAGAGGCG	AAGCAGGC
AAGAGGCT	AAGCAGGC
AACTTGNT	AACTTGTA
AAGAGGCN	AAGCAGGC
AAATATAT	TAATATAT
AAGAGGAG	AAGGGAGT
AACTTTAC	AACTTGTA
AACTTTAA	AACTTGTA
AACTTTAG	AACTTGTA
AACTTTAT	AACTTGTA
AACTTTAN	AACTTGTA
AACTTTGT	AACTTGTA
AACTTTTA	AACTTGTA
AAGGCAGG	AAGCAGGC
AAGNGAGT	AAGGGAGT
AAGGCAGT	AAGGGAGT
AAGNGGAG	AAGGGAGT
AACTTNGT	AACTTGTA
AAANAAGT	AAACAAGT
AACTTNTA	AACTTGTA
AATCTGAC	ATCTGACC
AAGGCGAG	AAGGGAGT
ACTTGGAG	TCTTGGAG
AATCTTGT	AACTTGTA
ACTTGTAC	AACTTGTA
ACTTGTAA	AACTTGTA
ACTTGTAG	AACTTGTA
ACTTGTAT	AACTTGTA
ACTTGTAN	AACTTGTA
AACTNGTA	AACTTGTA
AAGNTGCC	AAGTTGCC
AACTNTGT	AACTTGTA
ACTTTAAA	GCTTTAAA
AAGNTTGC	AAGTTGCC
AACNCCGC	AACCCGCG
AACNCGCG	AACCCGCG
AATACCTT	AAACCTTT
AAGGAAAT	AAGAAATC
AATACAAG	AAACAAGT
AAGGAAGT	AAGGGAGT
AAGGAATC	AAGAAATC
AANCCCGC	AACCCGCG
AAGGAGAG	AAGGGAGT
AAGGAGGC	AAGCAGGC
AGCACTTC	GCACTTCT
AAGGAGTC	AAGGGAGT
AAGGAGTA	AAGGGAGT
AAGGAGTG	AAGGGAGT
AAGGAGTT	AAGGGAGT
AANCCGCG	AACCCGCG
AAGGAGTN	AAGGGAGT
AAACACAG	AAACAAGT
AGCAACGC	ACAACGCG
AAACACGT	AAACAAGT
AAACACTT	AAACCTTT
AANCCTTT	AAACCTTT
AAACAACG	AAACAAGT
AAACAACT	AAACAAGT
AAACAAAG	AAACAAGT
AATAACTC	ATATAACT
AAACAAAT	AAACAAGT
AATAACTA	ATATAACT
AAACAAGC	AAACAAGT
AATAACTG	ATATAACT
AAACAAGA	AAACAAGT
AATAACTT	ATATAACT
AAACAAGG	AAACAAGT
AATAACTN	ATATAACT
AAACAAGT	AAACAAGT
AAACAAGN	AAACAAGT
AAACAATC	AAACAAGT
AGCAAAGT	GCAAAGTA
AAACAATA	AAACAAGT
AAACAATG	AAACAAGT
AAACAATT	AAACAAGT
AAACAATN	AAACAAGT
AAACAANG	AAACAAGT
AAACAANT	AAACAAGT
AAACAGAG	AAACAAGT
AAACAGGC	AAGCAGGC
AAACAGGT	AAACAAGT
AAACAGTC	AAACAAGT
AAACAGTA	AAACAAGT
AAACAGTG	AAACAAGT
AAACAGTT	AAACAAGT
AAACAGTN	AAACAAGT
AAACATAG	AAACAAGT
AATAAATC	AAGAAATC
AAGGGCCA	AGGGCCAA
AAACATGT	AAACAAGT
AAGGGCAG	AAGGGAGT
AAACATTT	AAACCTTT
AAGGGCGT	AAGGGAGT
AANCAAGT	AAACAAGT
AGCAATTA	ACAATTAG
AAACANAG	AAACAAGT
AAGGGACG	AAGGGAGT
AAACANGT	AAACAAGT
AAGGGACT	AAGGGAGT
AANCAGGC	AAGCAGGC
AAACGCGC	ACAACGCG
AAACGCGA	ACAACGCG
AAACGCGG	ACAACGCG
AAACGCGT	ACAACGCG
AAACGCGN	ACAACGCG
AAGGGAAG	AAGGGAGT
AAGGGAAT	AAGGGAGT
AAACGCTT	AAACCTTT
AAGGGAGC	AAGGGAGT
AAGGGAGA	AAGGGAGT
AAGGGAGG	AAGGGAGT
AAGGGAGT	AAGGGAGT
AAGGGAGN	AAGGGAGT
AAGGGATC	AAGGGAGT
AAGGGATA	AAGGGAGT
AAGGGATG	AAGGGAGT
AAGGGATT	AAGGGAGT
AAGGGATN	AAGGGAGT
AANTGGTC	AATGGTCA
AAGGGANG	AAGGGAGT
AAACGAAG	AAACAAGT
AAGGGANT	AAGGGAGT
AAACGAGT	AAACAAGT
AAGGGGAG	AAGGGAGT
AGCGTCGG	AGGGTCGG
AGCGTCTC	AGCGTTTC
AGCGTCTT	AGCGTTTC
AAGGGGGT	AAGGGAGT
AAGGGGTC	AAGGGAGT
AAGGGGTA	AAGGGAGT
AAGGGGTG	AAGGGAGT
AAGGGGTT	AAGGGAGT
AGCAGGCC	AAGCAGGC
AAGGGGTN	AAGGGAGT
AGCAGGCA	AAGCAGGC
AGCAGGCG	AAGCAGGC
AGCAGGCT	AAGCAGGC
AGCAGGCN	AAGCAGGC
AGCGTAAC	TAGCGTAA
AGCGTAAA	TAGCGTAA
AAGGGTCA	AATGGTCA
AGCGTAAG	TAGCGTAA
AAGGGTCG	AGGGTCGG
AGCGTAAT	TAGCGTAA
AGCGTAAN	TAGCGTAA
AANAAATC	AAGAAATC
AGCGTAGG	GCGTAGGT
AAGGGTAG	AAGGGAGT
AAACGTTT	AAACCTTT
AGCGTATC	AGCGTTTC
AGCGTATT	AGCGTTTC
AAGGGTGT	AAGGGAGT
AGCGTGTC	AGCGTTTC
AGCAGTTT	AGCGTTTC
AGCGTGTT	AGCGTTTC
AGCGTTCC	AGCGTTTC
AGCGTTCA	AGCGTTTC
AGCGTTCG	AGCGTTTC
AGCGTTCT	AGCGTTTC
AGCGTTCN	AGCGTTTC
AGCGTTAC	AGCGTTTC
AAGGGNAG	AAGGGAGT
AGCGTTAT	AGCGTTTC
AAACTCTT	AAACCTTT
AGCGTTGC	AGCGTTTC
AAGGGNGT	AAGGGAGT
AGCGTTGT	AGCGTTTC
AGCGTTTC	AGCGTTTC
AGCGTTTA	AGCGTTTC
AANTTGCC	AAGTTGCC
AGCGTTTG	AGCGTTTC
AGCGTTTT	AGCGTTTC
AGCGTTTN	AGCGTTTC
AGCGTTNC	AGCGTTTC
AAACTAAG	AAACAAGT
AGCGTTNT	AGCGTTTC
AAACTAGT	AAACAAGT
AANTTGTA	AACTTGTA
AGCATCGT	ACATCGTT
AGCGTNTC	AGCGTTTC
AGCGTNTT	AGCGTTTC
AAGGTCAC	AATGGTCA
AAACTTGT	AACTTGTA
AAGGTCAA	AATGGTCA
AAGGTCAG	AATGGTCA
AAACTTTC	AAACCTTT
AAGGTCAT	AATGGTCA
AAACTTTA	AAACCTTT
AAGGTCAN	AATGGTCA
AAACTTTG	AAACCTTT
AAACTTTT	AAACCTTT
AAACTTTN	AAACCTTT
AAGGTCGG	AGGGTCGG
AGCATTTC	AGCGTTTC
AACNTGTA	AACTTGTA
AAACNCTT	AAACCTTT
AAGGTAGT	AAGGGAGT
AGCGNTTC	AGCGTTTC
AAGGTGCC	AAGTTGCC
AGCGNTTT	AGCGTTTC
AAACNAAG	AAACAAGT
AACNTTGT	AACTTGTA
AAACNAGT	AAACAAGT
AANCTTGT	AACTTGTA
AGCTCCTC	ACGCTCCT
AGCTCCTA	ACGCTCCT
AGCTCCTG	ACGCTCCT
AGCTCCTT	ACGCTCCT
AGCTCCTN	ACGCTCCT
AAGGTGAG	AAGGGAGT
AAACNTTT	AAACCTTT
AGCTCAGC	CAGCTCAG
AGCTCAGA	CAGCTCAG
AGCTCAGG	CAGCTCAG
AGCTCAGT	CAGCTCAG
AGCTCAGN	CAGCTCAG
AGCTCGCC	GCTCGCCC
AAGGTTGC	AAGTTGCC
AAAACCTT	AAACCTTT
AAAACAAG	AAACAAGT
AGCGCCAA	AGGGCCAA
AAGGNAGT	AAGGGAGT
AAGGNGAG	AAGGGAGT
AAAACGCG	ACAACGCG
AAACCCGC	AACCCGCG
AANACCTT	AAACCTTT
AAACCCTT	AAACCTTT
AGCGCTCC	ACGCTCCT
AANACAAG	AAACAAGT
AAACCAAG	AAACAAGT
AAACCAGT	AAACAAGT
AGCGCTTC	AGCGTTTC
AAACCATT	AAACCTTT
AGCGCTTT	AGCGTTTC
AAACCGCG	AACCCGCG
AAACCGTT	AAACCTTT
AAACCTCT	AAACCTTT
AAACCTAT	AAACCTTT
AAAACTTT	AAACCTTT
AAACCTGT	AAACCTTT
AAACCTTC	AAACCTTT
AAACCTTA	AAACCTTT
AAACCTTG	AAACCTTT
AAACCTTT	AAACCTTT
AAACCTTN	AAACCTTT
AAACCTNT	AAACCTTT
AAGTCAGG	AAGCAGGC
AAACCNTT	AAACCTTT
AGCTGACC	ATCTGACC
AGAGGCCA	AGGGCCAA
AAGTCGCC	AAGTTGCC
AANGCAGG	AAGCAGGC
AAGTCGTA	ATGTCGTA
AGGCTCCT	ACGCTCCT
AGGCTCGG	AGGGTCGG
AAGTCTGC	AAGTTGCC
AGAGGGAG	AAGGGAGT
AGCGATTC	AGCGTTTC
AGCGATTT	AGCGTTTC
AGCTGTTT	AGCGTTTC
AATAGGTC	AATGGTCA
AGAGGTCG	AGGGTCGG
AATAGTCA	AATGGTCA
AGCGGCCA	AGGGCCAA
AAAAAAGT	AAACAAGT
AAAAAATC	AAGAAATC
AGCGGACT	TGCGGACT
AGCGGAAG	CGCGGAAG
AANGAAAT	AAGAAATC
AGAGTCGG	AGGGTCGG
AATATAAC	ATATAACT
AAAAAGTC	AAACAAGT
AAAAAGTA	AAACAAGT
AAAAAGTG	AAACAAGT
AGCTTGTA	AACTTGTA
AAAAAGTT	AAACAAGT
AAAAAGTN	AAACAAGT
AGCGGTCG	AGGGTCGG
AATATATC	TAATATAT
AATATATA	TAATATAT
AATATATG	TAATATAT
AGCTTTCC	AGCGTTTC
AATATATT	TAATATAT
AGCGGTAA	ACCGGTAA
AGCTTTCA	AGCGTTTC
AATATATN	TAATATAT
AGCTTTCG	AGCGTTTC
AGCTTTCT	AGCGTTTC
AAAAATCC	AAGAAATC
AGCTTTCN	AGCGTTTC
AAAAATCA	AAGAAATC
AAAAATCG	AAGAAATC
AGCTTTAA	GCTTTAAA
AGCGGTTC	AGCGTTTC
AGCGGTTT	AGCGTTTC
AGCTTTTC	AGCGTTTC
AGAGTGTT	GAGTGTTC
AAAAATCT	AAGAAATC
AAAAATCN	AAGAAATC
AGAGTTGC	AAGTTGCC
AGAGTTTC	AGCGTTTC
AATATTTC	ATATTTCC
AANGGAGT	AAGGGAGT
AGGACCAA	AGGGCCAA
AAAAGCCA	CAAAGCCA
AANGGGAG	AAGGGAGT
AANGGTCA	AATGGTCA
AGGNCCAA	AGGGCCAA
AGATCCCT	TGATCCCT
AAAAGGAT	TAAAGGAT
AATGCAGG	AAGCAGGC
AGGAAATC	AAGAAATC
AGATCGAT	GATCGATA
AGCCCCTT	GCCCCTTT
AANGTTGC	AAGTTGCC
AGATCGTT	ACATCGTT
AATGCGTC	AATGGTCA
AGCCCGCG	AACCCGCG
AATGCTCA	AATGGTCA
AGCCCTTG	ACCCTTGG
AGGAGCCA	AGGGCCAA
AGATAACT	ATATAACT
AATGAAAT	AAGAAATC
AGTCGTAC	ATGTCGTA
AGTCGTAA	ATGTCGTA
AGTCGTAG	ATGTCGTA
AGTCGTAT	ATGTCGTA
AGTCGTAN	ATGTCGTA
AGTCGTTT	AGCGTTTC
AATGAGTC	AATGGTCA
AGGAGTCG	AGGGTCGG
AATGATCA	AATGGTCA
AGGNGCCA	AGGGCCAA
AGCCGGGT	GCCGGGTC
AGCCGGTA	ACCGGTAA
AATGGCCA	AATGGTCA
AATGGCAC	AATGGTCA
AATGGCAA	AATGGTCA
AATGGCAG	AATGGTCA
AATGGCAT	AATGGTCA
AAAATTAG	ACAATTAG
AATGGCAN	AATGGTCA
AGGATCGG	AGGGTCGG
AGTCTGAC	ATCTGACC
AGCCGTTT	AGCGTTTC
AATGGCTC	AATGGTCA
AATGGACA	AATGGTCA
AGGNGTCG	AGGGTCGG
AATGGAGT	AAGGGAGT
AATGGATC	AATGGTCA
AATGGGCA	AATGGTCA
AATGGGAG	AAGGGAGT
AATGGGTC	AATGGTCA
AGGATTCC	CGGATTCC
AATGGTCC	AATGGTCA
AATGGTCA	AATGGTCA
AATGGTCG	AATGGTCA
AATGGTCT	AATGGTCA
AATGGTCN	AATGGTCA
AATGGTAC	AATGGTCA
AATGGTAA	AATGGTCA
AATGGTAG	AATGGTCA
AATGGTAT	AATGGTCA
AATGGTAN	AATGGTCA
AATGGTGC	AATGGTCA
AATGGTGA	AATGGTCA
AGATGGTC	AATGGTCA
AATGGTTC	AATGGTCA
AATGGTTA	AATGGTCA
AGGNTCGG	AGGGTCGG
AATGGTNC	AATGGTCA
AATGGTNA	AATGGTCA
AATGGNCA	AATGGTCA
AATTCCTG	ATTCCTGC
AGCCTTAG	GCCTTAGT
AATGGNTC	AATGGTCA
AGCCTTGG	ACCCTTGG
AGCCTTTC	AGCGTTTC
AATGTCAC	AATGGTCA
AATGTCAA	AATGGTCA
AATGTCAG	AATGGTCA
AATGTCAT	AATGGTCA
AATGTCAN	AATGGTCA
AATGTCGT	ATGTCGTA
AATTCAAG	ATTCAAGG
AGATTATT	CGATTATT
AATGTGTC	AATGGTCA
AATGTTCA	AATGGTCA
AGTACCCT	GTACCCTG
AATGTTGC	AAGTTGCC
AGATTTCC	ATATTTCC
AGGGCCCA	AGGGCCAA
AGGGCCAC	AGGGCCAA
AGGGCCAA	AGGGCCAA
AGGGCCAG	AGGGCCAA
AGGGCCAT	AGGGCCAA
AGGGCCAN	AGGGCCAA
AGGGCCGA	AGGGCCAA
AGGGCCGG	AGGGTCGG
AGGGCCTA	AGGGCCAA
AGGGACCA	AGGGCCAA
AGTACGGA	GTACGGAT
AGGGCCNA	AGGGCCAA
AGGGACAA	AGGGCCAA
AGGGCACA	AGGGCCAA
AGGGACGG	AGGGTCGG
AGGGCAAC	AGGGCCAA
AGGGCAAA	AGGGCCAA
AGGGCAAG	AGGGCCAA
AGGGCAAT	AGGGCCAA
AGGGCAAN	AGGGCCAA
AGGGCGCA	AGGGCCAA
AGGGCGAA	AGGGCCAA
AGGGCGGC	AGGGTCGG
AGGGCGGA	AGGGTCGG
AGGGCGGG	AGGGTCGG
AGGGCGGT	AGGGTCGG
AGGGCGGN	AGGGTCGG
AATGNGTC	AATGGTCA
AGGGAGTC	AAGGGAGT
AGGGAGTA	AAGGGAGT
AGGGCTCA	AGGGCCAA
AGGGAGTG	AAGGGAGT
AGGGCTCG	AGGGTCGG
AGGGAGTT	AAGGGAGT
AGGGAGTN	AAGGGAGT
AGGGCTAA	AGGGCCAA
AATGNTCA	AATGGTCA
AGGGATCG	AGGGTCGG
AGGGCNCA	AGGGCCAA
AGGGCNAA	AGGGCCAA
AGGGGCCA	AGGGCCAA
AGGGGCAA	AGGGCCAA
AGGGGCGG	AGGGTCGG
AGGGGAGT	AAGGGAGT
AGGGGTCG	AGGGTCGG
AGTCCTGC	ATTCCTGC
AGGGTCCA	AGGGCCAA
AGGGTCCG	AGGGTCGG
AGGGTCAA	AGGGCCAA
AGGGTCAG	AGGGTCGG
AGGGTCGC	AGGGTCGG
AGGGTCGA	AGGGTCGG
AGGGTCGG	AGGGTCGG
AGGGTCGT	AGGGTCGG
AGGGTCGN	AGGGTCGG
AGGGTCTG	AGGGTCGG
AGGGTCNG	AGGGTCGG
AGGGTACG	AGGGTCGG
AGGGTAGG	AGGGTCGG
AGGGTGCG	AGGGTCGG
AGGGTGGC	AGGGTCGG
AGGGTGGA	AGGGTCGG
AGGGTGGG	AGGGTCGG
AGGGTGGT	AGGGTCGG
AGGGTGGN	AGGGTCGG
AGTCAAGC	GTCAAGCC
AGTCAAGG	ATTCAAGG
AGGGTTCG	AGGGTCGG
AGGGTTGG	AGGGTCGG
AGGGTTTC	AGCGTTTC
AGGGTNCG	AGGGTCGG
AATTGCCC	AAGTTGCC
AGGGTNGG	AGGGTCGG
AATTGCCA	AAGTTGCC
AATTGCCG	AAGTTGCC
AATTGCCT	AAGTTGCC
AATTGCCN	AAGTTGCC
AGGGNCCA	AGGGCCAA
AGGGNCAA	AGGGCCAA
AGGGNCGG	AGGGTCGG
AGCNGTTT	AGCGTTTC
AGTATACG	CGTATACG
AGTATAAC	ATATAACT
AGGCCCAA	AGGGCCAA
AGNCGTTT	AGCGTTTC
AGTATGGC	TAGTATGG
AGTATGGA	TAGTATGG
AGTATGGG	TAGTATGG
AGTATGGT	TAGTATGG
AATTGGTC	AATGGTCA
AGTATGGN	TAGTATGG
AATTGTCA	AATGGTCA
ATCATCGT	ACATCGTT
AATTGTAC	AACTTGTA
AGGGNTCG	AGGGTCGG
AATTGTAA	AACTTGTA
AATTGTAG	AACTTGTA
AATTGTAT	AACTTGTA
AGGCCAAC	AGGGCCAA
AGGCCAAA	AGGGCCAA
AATTGTAN	AACTTGTA
AGGCCAAG	AGGGCCAA
AGGCCAAT	AGGGCCAA
AGGCCAAN	AGGGCCAA
AGTATTTC	ATATTTCC
ATCATAAC	ATATAACT
AATTTCCC	ATATTTCC
AATTTCCA	ATATTTCC
AATTTCCG	ATATTTCC
ATCATGAC	ATCTGACC
AATTTCCT	ATATTTCC
AGGTCCAA	AGGGCCAA
AATTTCCN	ATATTTCC
AGCNTTTC	AGCGTTTC
ATCATTTC	ATATTTCC
AATTTGCC	AAGTTGCC
AGGTCGGC	AGGGTCGG
AGGTCGGA	AGGGTCGG
AGGTCGGG	AGGGTCGG
AGGTCGGT	AGGGTCGG
AGGTCGGN	AGGGTCGG
AGGTCGTA	ATGTCGTA
AATTTGTA	AACTTGTA
ATCTACCC	ATCTGACC
ATCTACCA	ATCTGACC
ATCTACCG	ATCTGACC
ATCTACCT	ATCTGACC
ATCTACCN	ATCTGACC
ATCTACAT	TTCTACAT
ATCTAACC	ATCTGACC
ATCTAACT	ATATAACT
AGACCCGC	AACCCGCG
AGACCCGG	CGACCCGG
AGGTGCCA	AGGGCCAA
ATCTAGAC	ATCTGACC
AGGCAGGC	AAGCAGGC
AGACCTTT	AAACCTTT
AGGTGGTT	CGGTGGTT
AGGTGTCG	AGGGTCGG
ATCTGCCC	ATCTGACC
ATCTGCCA	ATCTGACC
ATCTGCCG	ATCTGACC
ATCTGCCT	ATCTGACC
ATCTGCCN	ATCTGACC
ATCTGCAC	ATCTGACC
AGGCGCCA	AGGGCCAA
ATCGCTCC	ACGCTCCT
AGGCGCAT	TGGCGCAT
ATCTGACC	ATCTGACC
ATCTGACA	ATCTGACC
ATCTGACG	ATCTGACC
ATCTGACT	ATCTGACC
ATCTGACN	ATCTGACC
ATCTGAAC	ATCTGACC
ATCTGAGC	ATCTGACC
ATCTGATC	ATCTGACC
ATCTGANC	ATCTGACC
AGGTTCGG	AGGGTCGG
ATCTGGCC	ATCTGACC
ATCTGGAC	ATCTGACC
AGACAAGT	AAACAAGT
ATCGACCC	ATCTGACC
ATCGACCA	ATCTGACC
ATCTGTCC	ATCTGACC
ATCGACCG	ATCTGACC
ATCGACCT	ATCTGACC
ATCGACCN	ATCTGACC
ATCTGTAC	ATCTGACC
AGGTTGCC	AAGTTGCC
AGGCGTCG	AGGGTCGG
ATCTGNCC	ATCTGACC
ATCTGNAC	ATCTGACC
AGGTTTCC	AGCGTTTC
AGGTTTCA	AGCGTTTC
AGGTTTCG	AGCGTTTC
AGGCGTTT	AGCGTTTC
AGGTTTCT	AGCGTTTC
AGGTTTCN	AGCGTTTC
ATCTTACC	ATCTGACC
ATCGATAC	GATCGATA
ATCGATAA	GATCGATA
ATCGATAG	GATCGATA
ATCGATAT	GATCGATA
ATCGATAN	GATCGATA
ATCTTGAC	ATCTGACC
ATCTTGGA	TCTTGGAG
ATCTTGTA	AACTTGTA
ATCCCGCG	AACCCGCG
ATCTTTCC	ATATTTCC
ATCGGCAG	TTCGGCAG
ATCCCTGC	ATTCCTGC
ATCCCTTG	ACCCTTGG
AGACGTTT	AGCGTTTC
ATCGGACC	ATCTGACC
AGNGCCAA	AGGGCCAA
ATCTNACC	ATCTGACC
ATCCAACG	TCCAACGA
ATCCAAGG	ATTCAAGG
AGACTAAC	GACTAACT
ATCTNGAC	ATCTGACC
ATCGGTAA	ACCGGTAA
AGACTTGT	AACTTGTA
ATCGTCGT	ATGTCGTA
ATCCGCTA	TCCGCTAG
ATCCGACC	ATCTGACC
AGTGCCAA	AGGGCCAA
ATGAACTG	TGAACTGT
ATCCGAGC	CATCCGAG
ATCCGAGA	CATCCGAG
ATCCGAGG	CATCCGAG
ATCCGAGT	CATCCGAG
ATCCGAGN	CATCCGAG
ATCGTGAC	ATCTGACC
ATGAAATC	AAGAAATC
ATCCGGTA	ACCGGTAA
ATCGTTTC	AGCGTTTC
AGNGGCCA	AGGGCCAA
AATNGGTC	AATGGTCA
AATNGTCA	AATGGTCA
ATATCCTG	ATTCCTGC
ATCCTGCC	ATTCCTGC
ATCCTGCA	ATTCCTGC
ATCCTGCG	ATTCCTGC
ATCCTGCT	ATTCCTGC
ATCCTGCN	ATTCCTGC
ATCCTGAC	ATCTGACC
ATATCACT	ATATAACT
ATATCAAC	ATATAACT
ATATCAAG	ATTCAAGG
ATCCTTCA	TCCTTCAC
ATCCTTGG	ACCCTTGG
AGNGGTCG	AGGGTCGG
ATATCGTA	ATGTCGTA
ATGAGTTA	TTGAGTTA
ATATCGTT	ACATCGTT
AGNGTCGG	AGGGTCGG
ATATCTCC	ATATTTCC
ATGATCCC	TGATCCCT
ATCNGACC	ATCTGACC
ATATCTTC	ATATTTCC
ATCTCCGG	TCTCCGGG
ATGATCGT	ATGTCGTA
ATCTCCTG	ATTCCTGC
ATCTCACC	ATCTGACC
ATCTCAAG	ATTCAAGG
ATGATAAC	ATATAACT
AGNGTTTC	AGCGTTTC
ATCTCGAC	ATCTGACC
ATCTCGTA	ATGTCGTA
AGTGGCCA	AGGGCCAA
ATGATTTC	ATATTTCC
ATATACCT	ATATAACT
ATATACAC	ATATAACT
AGAACCTT	AAACCTTT
AGTGGACA	GTGGACAA
AGAACAAG	AAACAAGT
ATATACTC	ATATAACT
ATATACTA	ATATAACT
ATATACTG	ATATAACT
ATATACTT	ATATAACT
ATATACTN	ATATAACT
ATATAACC	ATATAACT
ATATAACA	ATATAACT
AGAACGCG	ACAACGCG
ATATAACG	ATATAACT
ATATAACT	ATATAACT
ATATAACN	ATATAACT
ATATAAAC	ATATAACT
ATATAAAT	ATATAACT
AGTGGGGT	TGTGGGGT
ATATAAGC	ATATAACT
ATCNTGAC	ATCTGACC
AGTGGTCA	AATGGTCA
AGTGGTCG	AGGGTCGG
ATATAAGT	ATATAACT
ATATAATC	ATATAACT
ATATAATA	ATATAACT
ATATAATG	ATATAACT
ATATAATT	ATATAACT
ATATAATN	ATATAACT
ATATAANC	ATATAACT
AGAACTGT	TGAACTGT
ATATAANT	ATATAACT
ATATAGCT	ATATAACT
ATATAGAC	ATATAACT
ATATATCC	ATATTTCC
ATATATCT	ATATAACT
ATATATAC	ATATAACT
ATCAACGC	ACAACGCG
AGTGTCGG	AGGGTCGG
AGTGTCGT	ATGTCGTA
ATATATTC	ATATTTCC
ATTACCAA	CTTACCAA
ATTACCTG	ATTCCTGC
ATATANCT	ATATAACT
ATATANAC	ATATAACT
ATTACAAG	ATTCAAGG
ATGNTCGT	ATGTCGTA
ATCAAGCC	GTCAAGCC
ATGGCCAA	AGGGCCAA
ATCAAGGC	ATTCAAGG
ATCAAGGA	ATTCAAGG
ATCAAGGG	ATTCAAGG
ATCAAGGT	ATTCAAGG
ATCAAGGN	ATTCAAGG
AGTGTTCC	GAGTGTTC
AGTGTTCA	GAGTGTTC
AGTGTTCG	GAGTGTTC
AGTGTTCT	GAGTGTTC
AGTGTTCN	GAGTGTTC
ATCAATTA	ACAATTAG
AGAAATCC	AAGAAATC
AGAAATCA	AAGAAATC
AGAAATCG	AAGAAATC
AGAAATCT	AAGAAATC
ATTACTGC	ATTCCTGC
AGAAATCN	AAGAAATC
AGTGTTTC	AGCGTTTC
ATGGCGCA	TGGCGCAT
ATATGACC	ATCTGACC
ATATGACT	ATATAACT
ATATGAAC	ATATAACT
ATGGCGTA	ATGTCGTA
ATTAACCC	TTAACCCC
ATATGGTC	AATGGTCA
ATCAGACC	ATCTGACC
ATTAACTC	ATATAACT
ATTAACTA	ATATAACT
ATATGTCC	ATATTTCC
ATTAACTG	ATATAACT
ATTAACTT	ATATAACT
ATCAGAAA	TCAGAAAC
ATTAACTN	ATATAACT
ATATGTTC	ATATTTCC
ATTAAAGG	ATTCAAGG
ATCAGGTC	TCAGGTCT
ATGGACAA	GTGGACAA
ATTAAGGC	ATTCAAGG
ATATTCCC	ATATTTCC
ATTAAGGA	ATTCAAGG
ATATTCCA	ATATTTCC
ATTAAGGG	ATTCAAGG
ATATTCCG	ATATTTCC
ATTAAGGT	ATTCAAGG
ATATTCCT	ATATTTCC
ATTAAGGN	ATTCAAGG
ATATTCCN	ATATTTCC
ATATTCTC	ATATTTCC
ATATTACC	ATATTTCC
ATTAATGC	CTTAATGC
ATATTACT	ATATAACT
ATATTAAC	ATATAACT
ATATTATC	ATATTTCC
ATATTGCC	ATATTTCC
AGAAGGGC	GAGAAGGG
AGAAGGGA	GAGAAGGG
AGAAGGGG	GAGAAGGG
AGAAGGGT	GAGAAGGG
ATATTGTC	ATATTTCC
AGAAGGGN	GAGAAGGG
ATATTTCC	ATATTTCC
ATATTTCA	ATATTTCC
ATATTTCG	ATATTTCC
ATATTTCT	ATATTTCC
ATATTTCN	ATATTTCC
ATATTTAC	ATATTTCC
ATATTTGC	ATATTTCC
ATATTTTC	ATATTTCC
AGTTCCTG	ATTCCTGC
ATATTTNC	ATATTTCC
ATATTNCC	ATATTTCC
ATTCCCGC	ATTCCTGC
AGTTCAAG	ATTCAAGG
ATATTNTC	ATATTTCC
ATTCCCTG	ATTCCTGC
ATTCCAAG	ATTCAAGG
ATTCCAGC	ATTCCTGC
ATTCCAGG	ATTCAAGG
ATTCCATG	ATTCCTGC
AGAATCCT	GAATCCTC
ATGGGCCA	AGGGCCAA
ATATNACT	ATATAACT
ATTCCGCC	ATTCCTGC
ATATNAAC	ATATAACT
ATTCCGCA	ATTCCTGC
ATTCCGCG	ATTCCTGC
ATTCCGCT	ATTCCTGC
ATTCCGCN	ATTCCTGC
ATTCCGGC	ATTCCTGC
ATTCCGTG	ATTCCTGC
ATTCCTCC	ATTCCTGC
ATTCCTCA	ATTCCTGC
ATTCCTCG	ATTCCTGC
ATTCCTCT	ATTCCTGC
ATTCCTCN	ATTCCTGC
ATTCCTAC	ATTCCTGC
ATTCCTAG	ATTCCTGC
ATTCCTGC	ATTCCTGC
ATTCCTGA	ATTCCTGC
ATTCCTGG	ATTCCTGC
ATTCCTGT	ATTCCTGC
ATTCCTGN	ATTCCTGC
ATGGGAGT	AAGGGAGT
ATTCCTTC	ATTCCTGC
ATATNTCC	ATATTTCC
ATGGGATC	CTGGGATC
ATTCCTTG	ATTCCTGC
ATTCCTNC	ATTCCTGC
ATTCCTNG	ATTCCTGC
ATATNTTC	ATATTTCC
ATGTCCGT	ATGTCGTA
ATGTCCTA	ATGTCGTA
ATGTCCTG	ATTCCTGC
ATTCCNGC	ATTCCTGC
ATTCCNTG	ATTCCTGC
ATGTCAAG	ATTCAAGG
ATTATAAC	ATATAACT
ATTCACAG	ATTCAAGG
ATGGGTCG	AGGGTCGG
ATGTCAGT	ATGTCGTA
ATGTCATA	ATGTCGTA
ATTCACGG	ATTCAAGG
ATTCACTG	ATTCCTGC
AGAATTAG	ACAATTAG
ATGTCGCA	ATGTCGTA
ATANTAAC	ATATAACT
ATGTCGCT	ATGTCGTA
ATGTCGAC	ATGTCGTA
ATTCAACG	ATTCAAGG
ATGTCGAA	ATGTCGTA
ATGTCGAG	ATGTCGTA
ATGTCGAT	ATGTCGTA
ATGTCGAN	ATGTCGTA
ATTCAAAG	ATTCAAGG
ATGTCGGA	ATGTCGTA
ATGTCGGT	ATGTCGTA
ATTCAAGC	ATTCAAGG
ATTCAAGA	ATTCAAGG
ATGTCGTC	ATGTCGTA
ATTCAAGG	ATTCAAGG
ATGTCGTA	ATGTCGTA
ATTCAAGT	ATTCAAGG
ATGTCGTG	ATGTCGTA
ATTCAAGN	ATTCAAGG
ATGTCGTT	ATGTCGTA
ATGTCGTN	ATGTCGTA
ATTCAATG	ATTCAAGG
ATGTCGNA	ATGTCGTA
ATGTCGNT	ATGTCGTA
ATTCAANG	ATTCAAGG
ATGTCTAC	ATGTCGTA
ATTCAGAG	ATTCAAGG
ATGTCTAA	ATGTCGTA
ATGTCTAG	ATGTCGTA
ATGTCTAT	ATGTCGTA
ATTCAGGC	ATTCAAGG
ATGTCTAN	ATGTCGTA
ATTCAGGA	ATTCAAGG
ATTCAGGG	ATTCAAGG
ATTCAGGT	ATTCAAGG
ATTCAGGN	ATTCAAGG
ATGTCTGT	ATGTCGTA
ATTATTTC	ATATTTCC
ATGTCTTA	ATGTCGTA
ATGGTCAC	AATGGTCA
ATGGTCAA	AATGGTCA
ATGGTCAG	AATGGTCA
ATGGTCAT	AATGGTCA
ATGGTCAN	AATGGTCA
ATGGTCGG	AGGGTCGG
ATGGTCGT	ATGTCGTA
ATTCATAG	ATTCAAGG
ATTCATGC	ATTCCTGC
ATANTTCC	ATATTTCC
ATTCATGG	ATTCAAGG
ATGTCNGT	ATGTCGTA
ATGTCNTA	ATGTCGTA
AGTTGCCC	AAGTTGCC
ATTCANAG	ATTCAAGG
AGTTGCCA	AAGTTGCC
AGTTGCCG	AAGTTGCC
AGTTGCCT	AAGTTGCC
AGTTGCCN	AAGTTGCC
ATANTTTC	ATATTTCC
ATTCANGG	ATTCAAGG
ATGTACGT	ATGTCGTA
ATGTAACT	ATATAACT
ATGTAAGC	TTGTAAGC
ATTCGCTG	ATTCCTGC
ATANAACT	ATATAACT
ATTCGAAG	ATTCAAGG
ATTCGAGG	ATTCAAGG
ATTCGGCA	TTCGGCAG
AGAGCCAA	AGGGCCAA
AGAGCCGC	GAGAGCCG
AGAGCCGA	GAGAGCCG
AGAGCCGG	GAGAGCCG
AGAGCCGT	GAGAGCCG
AGAGCCGN	GAGAGCCG
ATGTAGTA	ATGTCGTA
ATTCGTAC	ATGTCGTA
ATTCGTAA	ATGTCGTA
ATTCGTAG	ATGTCGTA
ATTCGTAT	ATGTCGTA
ATTCGTAN	ATGTCGTA
ATTCGTGC	ATTCCTGC
AGAGCAGG	AAGCAGGC
ATTGCCTG	ATTCCTGC
ATTGCACG	TTGCACGA
ATTGCAAG	ATTCAAGG
ATTCTCTA	CTTCTCTA
ATTCTCTG	ATTCCTGC
ATTCTACA	TTCTACAT
ATTCTAAG	ATTCAAGG
ATTCTAGG	ATTCAAGG
ATGTGCGT	ATGTCGTA
ATTCTGCC	ATTCCTGC
ATTCTGCA	ATTCCTGC
ATTCTGCG	ATTCCTGC
ATTCTGCT	ATTCCTGC
ATTCTGCN	ATTCCTGC
ATTCTGAC	ATCTGACC
ATTGCTGC	ATTCCTGC
ATTCTTGC	ATTCCTGC
ATGTGACC	ATCTGACC
AGAGAAAT	AAGAAATC
AGAGAAGG	GAGAAGGG
ATTGACCC	ATCTGACC
ATTGACCA	ATCTGACC
ATTGACCG	ATCTGACC
AGAGAGCC	GAGAGCCG
ATTGACCT	ATCTGACC
ATTGACCN	ATCTGACC
ATACCCGC	AACCCGCG
ATACCCTG	GTACCCTG
ATGTGGGG	TGTGGGGT
ATGTGGTA	ATGTCGTA
ATACCACC	TACCACCA
ATTGAAGG	ATTCAAGG
ATTCNCTG	ATTCCTGC
ATGTGTAC	ATGTCGTA
ATGTGTAA	ATGTCGTA
ATGTGTAG	ATGTCGTA
ATGTGTAT	ATGTCGTA
ATGTGTAN	ATGTCGTA
ATTCNAAG	ATTCAAGG
ATTCNAGG	ATTCAAGG
ATTGAGTT	TTGAGTTA
AGTTTCCC	GTTTCCCG
ATACCTGC	ATTCCTGC
ATACCTTT	AAACCTTT
ATTCNTGC	ATTCCTGC
ATGTTCGT	ATGTCGTA
ATGCCGTA	ATGTCGTA
AGTTTGCA	GTTTGCAT
ATGTTGCC	AAGTTGCC
ATGCCTGC	ATTCCTGC
AGTTTTGA	TGTTTTGA
ATACAACT	ATATAACT
ATACAAGG	ATTCAAGG
ATACAAGT	AAACAAGT
ATGTTGTA	ATGTCGTA
ATGTTTCC	ATATTTCC
ATTGGTCA	AATGGTCA
ATGTTTTG	TGTTTTGA
ATGCACGA	TTGCACGA
ATGCAAGG	ATTCAAGG
ATGCAGGC	AAGCAGGC
ATGTNCGT	ATGTCGTA
ATACGGAT	GTACGGAT
ANCGGTAA	ACCGGTAA
ATGTNGTA	ATGTCGTA
ATACTAAC	ATATAACT
ATGCGGAC	TGCGGACT
ATACTGAC	ATCTGACC
ATGCGTAC	ATGTCGTA
ATGCGTAA	ATGTCGTA
ATGCGTAG	ATGTCGTA
ATGCGTAT	ATGTCGTA
ATGCGTAN	ATGTCGTA
ATACTTCC	ATATTTCC
ATGCGTTT	AGCGTTTC
ATACTTGT	AACTTGTA
ATACTTTC	ATATTTCC
ATNATAAC	ATATAACT
ANCGTTTC	AGCGTTTC
ATGCTCCT	ACGCTCCT
ATNATTTC	ATATTTCC
ATGCTCGT	ATGTCGTA
ATGNCGTA	ATGTCGTA
ATGCTGAC	ATCTGACC
ANCCCGCG	AACCCGCG
ATAACCCC	TTAACCCC
ANCCCTTG	ACCCTTGG
ATAACCTT	AAACCTTT
ATAACAAG	AAACAAGT
ATAACGCG	ACAACGCG
ATAAACTC	ATATAACT
ATAAACTA	ATATAACT
ATAAACTG	ATATAACT
ATAAACTT	ATATAACT
ATAAACTN	ATATAACT
ATAAAACT	ATATAACT
ATAAAGGA	TAAAGGAT
ATGACGTA	ATGTCGTA
ANCCGGTA	ACCGGTAA
ATTGTCGT	ATGTCGTA
ANCTGACC	ATCTGACC
ATTGTAAG	TTGTAAGC
ATTGTGGC	TTTGTGGC
ANACCCGC	AACCCGCG
ANATTTCC	ATATTTCC
ANCCTTGG	ACCCTTGG
ATAAGAAC	CTAAGAAC
ATNGTCGT	ATGTCGTA
ANACCTTT	AAACCTTT
ANCTTGTA	AACTTGTA
ANGGCCAA	AGGGCCAA
ATAATCGA	TAATCGAG
ATTTCCCG	GTTTCCCG
ATAATAAC	ATATAACT
ANACAAGT	AAACAAGT
ATTTCCTG	ATTCCTGC
ATAATATA	TAATATAT
ATTTCAAG	ATTCAAGG
ATAATTCC	ATATTTCC
ATAATTAG	ACAATTAG
ATAATTTC	ATATTTCC
ATTTCGTA	ATGTCGTA
ATTTCTGC	ATTCCTGC
ANTCCTGC	ATTCCTGC
ANTATAAC	ATATAACT
ATTTAACT	ATATAACT
ATTTAAGG	ATTCAAGG
ANTCAAGG	ATTCAAGG
ATNTCCTG	ATTCCTGC
ANTATTTC	ATATTTCC
ATNTCAAG	ATTCAAGG
ANCAACGC	ACAACGCG
ANGGGCCA	AGGGCCAA
ATNTCGTA	ATGTCGTA
ATAGCAGG	AAGCAGGC
ATTTGCAT	GTTTGCAT
ATAGCATT	CTAGCATT
ANGGGAGT	AAGGGAGT
ATTTGACC	ATCTGACC
ATAGCGTA	TAGCGTAA
ANCAATTA	ACAATTAG
ANGGGTCG	AGGGTCGG
ATNTAACT	ATATAACT
ATTTGTGG	TTTGTGGC
ATAGAACT	ATATAACT
ATAGAAAT	AAGAAATC
ATTTTCCC	ATATTTCC
ATTTTCCA	ATATTTCC
ATTTTCCG	ATATTTCC
ATTTTCCT	ATATTTCC
ATTTTCCN	ATATTTCC
ANGGTCGG	AGGGTCGG
ANTCTGAC	ATCTGACC
ATNTGACC	ATCTGACC
ATTTTTCC	ATATTTCC
ATAGGCCC	CTAGGCCC
ANCATCGT	ACATCGTT
ATAGGGAG	AAGGGAGT
ATAGTCGT	ATGTCGTA
ATNTTTCC	ATATTTCC
ATAGTAAC	ATATAACT
ATAGTATG	TAGTATGG
ATTNCCTG	ATTCCTGC
ATTNCAAG	ATTCAAGG
ATAGTTCC	ATATTTCC
ANTGGTCA	AATGGTCA
ATAGTTGC	AAGTTGCC
ATAGTTTC	ATATTTCC
ATTNCTGC	ATTCCTGC
ANGTCGTA	ATGTCGTA
ANTGTCGT	ATGTCGTA
ANGCAGGC	AAGCAGGC
ATTNAAGG	ATTCAAGG
ANCGCTCC	ACGCTCCT
ANACTTGT	AACTTGTA
ANTTCCTG	ATTCCTGC
ANTTCAAG	ATTCAAGG
ANGCGTTT	AGCGTTTC
GCCGNGGT	GCCGGGTC
GCCGNGTC	GCCGGGTC
ANGCTCCT	ACGCTCCT
GCCTCCTT	GCCCCTTT
ANAACCTT	AAACCTTT
GCCNGGGT	GCCGGGTC
GCCNGGTC	GCCGGGTC
GCCTCAGT	GCCTTAGT
ANAACAAG	AAACAAGT
GCCTCGCC	GCTCGCCC
GCCTCGAT	CCTCGATT
ANAACGCG	ACAACGCG
ANGTTGCC	AAGTTGCC
GCCTCTAG	GCCTTAGT
GCCCCCTT	GCCCCTTT
GCCTCTTT	GCCCCTTT
GCCCCACT	CCCCACTG
GCCCCATT	GCCCCTTT
GCCNTAGT	GCCTTAGT
GCCCCGTT	GCCCCTTT
GCCTAACT	GACTAACT
GCCCCTCT	GCCCCTTT
GCCTAAGT	GCCTTAGT
GCCCCTAA	CCCCTAAA
GCCCCTAT	GCCCCTTT
GCCCCTGT	GCCCCTTT
GCCCCTTC	GCCCCTTT
GCCCCTTA	GCCCCTTT
GCCCCTTG	GCCCCTTT
GCCNTTAG	GCCTTAGT
GCCCCTTT	GCCCCTTT
GCCCCTTN	GCCCCTTT
GCCCCTNT	GCCCCTTT
GCCTAGGT	GCGTAGGT
GCCTAGTC	GCCTTAGT
GCCTAGTA	GCCTTAGT
GCCTAGTG	GCCTTAGT
GCCTAGTT	GCCTTAGT
GCCTAGTN	GCCTTAGT
GCCCCNTT	GCCCCTTT
GCCTATAG	GCCTTAGT
GCCCACTG	CCCCACTG
GCCCACTT	GCCCCTTT
GCCTGCAA	CCTGCAAG
ATNCCTGC	ATTCCTGC
GCCCAGTT	CCCAGTTA
GCCTGAGT	GCCTTAGT
GCCCATCC	CCCATCCA
GCCCATTT	GCCCCTTT
GCCTGGGT	GCCGGGTC
GCCTGGTC	GCCGGGTC
ATNCAAGG	ATTCAAGG
GCCTGTCG	CCCTGTCG
GCCTGTAG	GCCTTAGT
GCCCGCCC	GCTCGCCC
GCACCCTG	GTACCCTG
GCACCCTT	GCCCCTTT
ANGAAATC	AAGAAATC
GCCCGCTT	GCCCCTTT
GCCTTCAC	TCCTTCAC
GCCTTCAG	GCCTTAGT
GCCTTCGT	GCCTTAGT
GCCTTCTC	GCACTTCT
GCCTTCTA	GCACTTCT
GCCTTCTG	GCACTTCT
GCCTTCTT	GCACTTCT
GCCTTCTN	GCACTTCT
GCCTTACG	GCCTTAGT
GCCCGGGT	GCCGGGTC
GCCTTACT	GCCTTAGT
GCACCTCT	GCACTTCT
GCCCGGTC	GCCGGGTC
GCCTTAAA	GCTTTAAA
GCCTTAAG	GCCTTAGT
GCCTTAAT	GCCTTAGT
GCCTTAGC	GCCTTAGT
GCCTTAGA	GCCTTAGT
GCCTTAGG	GCCTTAGT
GCCTTAGT	GCCTTAGT
GCCTTAGN	GCCTTAGT
GCACCTTC	GCACTTCT
GCCTTATC	GCCTTAGT
GCCTTATA	GCCTTAGT
GCCTTATG	GCCTTAGT
GCACCTTT	GCCCCTTT
GCCTTATT	GCCTTAGT
GCCTTATN	GCCTTAGT
GCCTTANG	GCCTTAGT
GCCTTANT	GCCTTAGT
GCCCGTTT	GCCCCTTT
GCCTTGAG	GCCTTAGT
GCCTTGGT	GCCTTAGT
GCCTTGTC	GCCTTAGT
GCCTTGTA	GCCTTAGT
GCCTTGTG	GCCTTAGT
GCCTTGTT	GCCTTAGT
GCCTTGTN	GCCTTAGT
GCCTTTAA	GCTTTAAA
GCCTTTAG	GCCTTAGT
GCCTTTGT	GCCTTAGT
ANAATTAG	ACAATTAG
GCCTTNAG	GCCTTAGT
GCACAAGT	GCAAAGTA
GCCCTCTT	GCCCCTTT
GCCTTNGT	GCCTTAGT
GCCCTAAA	CCCCTAAA
GCCCTAGT	GCCTTAGT
GCACAGTA	GCAAAGTA
GCACATCT	GCACTTCT
GCACATTC	GCACTTCT
GCCTNAGT	GCCTTAGT
GCCCTGTC	CCCTGTCG
GCCCTTCT	GCACTTCT
GCCCTTAG	GCCTTAGT
ATNCTGAC	ATCTGACC
GCCCTTGG	ACCCTTGG
GCCCTTTC	GCCCCTTT
GCACGCCC	GCTCGCCC
GCCCTTTA	GCCCCTTT
GCCCTTTG	GCCCCTTT
GCCCTTTT	GCCCCTTT
GCCCTTTN	GCCCCTTT
GCCTNTAG	GCCTTAGT
GCACGGCA	CACGGCAT
GCACGGAT	GTACGGAT
GCCCNCTT	GCCCCTTT
GCACGGGT	GCCGGGTC
GCCNCCTT	GCCCCTTT
GCACGTCT	GCACTTCT
ANAGCAGG	AAGCAGGC
GCACGTTC	GCACTTCT
GCACTCCT	GCACTTCT
GCACTCTC	GCACTTCT
GCACTCTA	GCACTTCT
GCCCNTTT	GCCCCTTT
GCACTCTG	GCACTTCT
GCACTCTT	GCACTTCT
GCACTCTN	GCACTTCT
GCCNCTTT	GCCCCTTT
GCACTACT	GCACTTCT
GCACTAAC	GACTAACT
GCACTATC	GCACTTCT
GCACTGCT	GCACTTCT
GCACTGTC	GCACTTCT
ANAGAAAT	AAGAAATC
GCCACCTT	GCCCCTTT
GCACTTCC	GCACTTCT
GCACTTCA	GCACTTCT
GCACTTCG	GCACTTCT
GCACTTCT	GCACTTCT
GCACTTCN	GCACTTCT
GCACTTAC	GCACTTCT
GCACTTAG	GCCTTAGT
GCACTTAT	GCACTTCT
GCACTTGC	GCACTTCT
GCACTTGT	GCACTTCT
GCANAAGT	GCAAAGTA
GCACTTTC	GCACTTCT
GCACTTTA	GCACTTCT
GCACTTTG	GCACTTCT
GCACTTTT	GCACTTCT
GCACTTTN	GCACTTCT
GCACTTNC	GCACTTCT
GCACTTNT	GCACTTCT
GCACTNCT	GCACTTCT
GCACTNTC	GCACTTCT
GCANAGTA	GCAAAGTA
GCCACTTC	GCACTTCT
GCCACTTT	GCCCCTTT
GCTCTCCC	GCTCGCCC
GCACNTCT	GCACTTCT
ANAGGGAG	AAGGGAGT
GCTCTAAA	GCTTTAAA
GCACNTTC	GCACTTCT
GCTCTGCC	GCTCGCCC
GCTCTTCT	GCACTTCT
GCTCTTAA	GCTTTAAA
GCTCTTAG	GCCTTAGT
GCGGGGTC	GCCGGGTC
GCGGGTCC	GCCGGGTC
GCGGGTCA	GCCGGGTC
GCGGGTCG	GCCGGGTC
GCGGGTCT	GCCGGGTC
GCGGGTCN	GCCGGGTC
GCTCNCCC	GCTCGCCC
GCTCNGCC	GCTCGCCC
ANAGTTGC	AAGTTGCC
GCGGTAGG	GCGTAGGT
GCTGGCCC	GCTCGCCC
GCTGGACA	GTGGACAA
GCGGTGGT	CGGTGGTT
GCTACCCT	GTACCCTG
GCTGGGAT	CTGGGATC
GCANTTCT	GCACTTCT
GCTGGGTC	GCCGGGTC
GCTACGCC	GCTCGCCC
GCTACGGA	GTACGGAT
GCTACTTC	GCACTTCT
ANATCGTT	ACATCGTT
GCCAACGA	TCCAACGA
GCTAACTC	GACTAACT
GCTAACTA	GACTAACT
GCTAACTG	GACTAACT
GCTAACTT	GACTAACT
GCTAACTN	GACTAACT
GCTAAAGT	GCAAAGTA
GCCAAAGT	GCAAAGTA
GCCAAATG	CCAAATGG
GCCAAGCC	GTCAAGCC
GCTAAGAA	CTAAGAAC
GCTAAGTA	GCAAAGTA
GCCAAGTA	GCAAAGTA
ANATAACT	ATATAACT
GCGTCAGG	GCGTAGGT
GCGCCCTT	GCCCCTTT
GCGTCGCC	GCTCGCCC
GCGTCGGT	GCGTAGGT
GCTAGCCC	GCTCGCCC
GCTAGCAT	CTAGCATT
GCTAGGCC	CTAGGCCC
GCGCCTTT	GCCCCTTT
GCCAGGGT	GCCGGGTC
GCCAGGTC	GCCGGGTC
GCTAGGTC	GCGTAGGT
GCTAGGTA	GCGTAGGT
GCTGTAAA	GCTTTAAA
GCTAGGTG	GCGTAGGT
GCTAGGTT	GCGTAGGT
GCTAGGTN	GCGTAGGT
GCTGTAGG	GCGTAGGT
GCGTACGG	GCGTAGGT
GCGTACGT	GCGTAGGT
GCCAGTTA	CCCAGTTA
GCGTAAGG	GCGTAGGT
ANATGGTC	AATGGTCA
GCGTAAGT	GCGTAGGT
GCTGTTAA	GCTTTAAA
GCGTAGCG	GCGTAGGT
GCGTAGCT	GCGTAGGT
GCCATCCA	CCCATCCA
GCGTAGAG	GCGTAGGT
GCGTAGAT	GCGTAGGT
GCGTAGGC	GCGTAGGT
GCGTAGGA	GCGTAGGT
GCGTAGGG	GCGTAGGT
GCGTAGGT	GCGTAGGT
GCGTAGGN	GCGTAGGT
GCGTAGTC	GCGTAGGT
GCGTAGTA	GCGTAGGT
GCGTAGTG	GCGTAGGT
GCGTAGTT	GCGTAGGT
GCGTAGTN	GCGTAGGT
GCGTAGNG	GCGTAGGT
GCGTAGNT	GCGTAGGT
GCGCAGGT	GCGTAGGT
GCGTATAC	CGTATACG
GCTATAAA	GCTTTAAA
GCCATAGT	GCCTTAGT
GCGTATGG	GCGTAGGT
GCGTATGT	GCGTAGGT
GCGTANGG	GCGTAGGT
GCGTANGT	GCGTAGGT
GCTATTAA	GCTTTAAA
GCCATTAG	GCCTTAGT
GCGCGCCC	GCTCGCCC
GCGTGAGG	GCGTAGGT
GCGCGGAA	CGCGGAAG
GCGCGGGT	GCCGGGTC
GCTTCCCG	GTTTCCCG
GCGTGGGT	GCGTAGGT
GCGTGGTC	GCGTAGGT
GCGTGGTA	GCGTAGGT
GCGTGGTG	GCGTAGGT
GCGTGGTT	GCGTAGGT
GCGTGGTN	GCGTAGGT
GCTTCAAA	GCTTTAAA
GCGTGTTC	GAGTGTTC
GCAACAGT	GCAAAGTA
GCTTCGCC	GCTCGCCC
GCAACGCG	ACAACGCG
GCGCTCCT	ACGCTCCT
GCTTCTCT	CTTCTCTA
GCAACGTA	GCAAAGTA
GCTTCTAA	GCTTTAAA
GCAACTTC	GCACTTCT
GCCGCCCC	GCTCGCCC
GCGCTAGG	GCGTAGGT
GCCGCCCA	GCTCGCCC
GCCGCCCG	GCTCGCCC
GCTGCCCC	GCTCGCCC
GCCGCCCT	GCTCGCCC
GCTGCCCA	GCTCGCCC
GCCGCCCN	GCTCGCCC
GCTGCCCG	GCTCGCCC
GCTGCCCT	GCTCGCCC
GCTGCCCN	GCTCGCCC
GCGTTAAA	GCTTTAAA
GCGTTAGG	GCGTAGGT
GCGTTAGT	GCCTTAGT
GCTTACCA	CTTACCAA
GCCGCCTT	GCCCCTTT
GCTGCAAG	CCTGCAAG
GCGTTGAG	CCGTTGAG
GCGCTTCT	GCACTTCT
GCGTTGGT	GCGTAGGT
GCGCTTAG	GCCTTAGT
GCTTAAAC	GCTTTAAA
GCTTAAAA	GCTTTAAA
GCAAACGT	GCAAAGTA
GCTTAAAG	GCTTTAAA
GCAAACTA	GCAAAGTA
GCTTAAAT	GCTTTAAA
GCTTAAAN	GCTTTAAA
GCTGCGCC	GCTCGCCC
GCGTTTCC	AGCGTTTC
GCGTTTCA	AGCGTTTC
GCTTAATG	CTTAATGC
GCGTTTCG	AGCGTTTC
GCGTTTCT	AGCGTTTC
GCGTTTCN	AGCGTTTC
GCGTTTAA	GCTTTAAA
GCCGCGGT	GCCGGGTC
GCCGCGTC	GCCGGGTC
GCAAAAGT	GCAAAGTA
GCAAAATA	GCAAAGTA
GCTTAGGT	GCGTAGGT
GCTTAGTC	GCCTTAGT
GCTTAGTA	GCCTTAGT
GCTTAGTG	GCCTTAGT
GCTTAGTT	GCCTTAGT
GCCGCTAG	TCCGCTAG
GCTTAGTN	GCCTTAGT
GCAAAGCC	CAAAGCCA
GCAAAGCA	GCAAAGTA
GCAAAGCT	GCAAAGTA
GCAAAGAC	GCAAAGTA
GCAAAGAA	GCAAAGTA
GCAAAGAG	GCAAAGTA
GCAAAGAT	GCAAAGTA
GCAAAGAN	GCAAAGTA
GCCGCTTT	GCCCCTTT
GCAAAGGA	GCAAAGTA
GCTTATAA	GCTTTAAA
GCAAAGGT	GCAAAGTA
GCAAAGTC	GCAAAGTA
GCAAAGTA	GCAAAGTA
GCAAAGTG	GCAAAGTA
GCAAAGTT	GCAAAGTA
GCAAAGTN	GCAAAGTA
GCAAAGNA	GCAAAGTA
GCAAAGNT	GCAAAGTA
GCAAATAC	GCAAAGTA
GCAAATAA	GCAAAGTA
GCAAATAG	GCAAAGTA
GCAAATAT	GCAAAGTA
GCAAATAN	GCAAAGTA
GCAAATGG	CCAAATGG
GCAAATGT	GCAAAGTA
GCAAATTA	GCAAAGTA
GCTTGCCC	GCTCGCCC
GCGACCCG	CGACCCGG
GCTTGCAT	GTTTGCAT
GCAAANGT	GCAAAGTA
GCAAANTA	GCAAAGTA
GCGTNAGG	GCGTAGGT
GACTGACT	GACTAACT
GACTGAAC	GACTAACT
GCAAGCCC	GTCAAGCC
GCAAGCCA	GTCAAGCC
GCAAGCCG	GTCAAGCC
GCTTGAAA	GCTTTAAA
GCAAGCCT	GTCAAGCC
GCAAGCCN	GTCAAGCC
GCGTNGGT	GCGTAGGT
GCCGAGGT	GCCGGGTC
GCTTGGAG	TCTTGGAG
GCCGAGTC	GCCGGGTC
GCAAGAGT	GCAAAGTA
GCTTGTAA	GCTTTAAA
GACTGTTC	GAGTGTTC
GCGACTTC	GCACTTCT
GCAAGGTA	GCAAAGTA
GCAAGTAC	GCAAAGTA
GCAAGTAA	GCAAAGTA
GCAAGTAG	GCAAAGTA
GCAAGTAT	GCAAAGTA
GCAAGTAN	GCAAAGTA
GACCACCA	TACCACCA
GCTTTCCC	GTTTCCCG
GCTTTCAA	GCTTTAAA
GCCGGCGT	GCCGGGTC
GCCGGCTC	GCCGGGTC
GACTTCTC	GCACTTCT
GACTTCTA	GCACTTCT
GACTTCTG	GCACTTCT
GACTTCTT	GCACTTCT
GACTTCTN	GCACTTCT
GACTTACT	GACTAACT
GCTTTACA	GCTTTAAA
GACTTAAC	GACTAACT
GCTTTAAC	GCTTTAAA
GCTTTAAA	GCTTTAAA
GCTTTAAG	GCTTTAAA
GCTTTAAT	GCTTTAAA
GACCAACT	GACTAACT
GCTTTAAN	GCTTTAAA
GCTTTAGA	GCTTTAAA
GCCGGAGT	GCCGGGTC
GCTTTAGT	GCCTTAGT
GACTTAGT	GCCTTAGT
GCCGGATC	GCCGGGTC
GCTTTATA	GCTTTAAA
GCAATCCT	GAATCCTC
GCTTTANA	GCTTTAAA
GCCGGGCC	GCCGGGTC
GCCGGGCA	GCCGGGTC
GCCGGGCG	GCCGGGTC
GCTTTGCA	GTTTGCAT
GCCGGGCT	GCCGGGTC
GCCGGGCN	GCCGGGTC
GCCGGGAC	GCCGGGTC
GCGAAAGT	GCAAAGTA
GCTTTGAA	GCTTTAAA
GCCGGGAT	GCCGGGTC
GCCGGGGC	GCCGGGTC
GCCGGGGT	GCCGGGTC
GCCGGGTC	GCCGGGTC
GCCGGGTA	GCCGGGTC
GCCGGGTG	GCCGGGTC
GACTTGTA	AACTTGTA
GCCGGGTT	GCCGGGTC
GCCGGGTN	GCCGGGTC
GCCGGGNC	GCCGGGTC
GCCGGGNT	GCCGGGTC
GCCGGTCC	GCCGGGTC
GCAATAGT	GCAAAGTA
GCCGGTCA	GCCGGGTC
GCTTTTAA	GCTTTAAA
GCCGGTCG	GCCGGGTC
GCCGGTCT	GCCGGGTC
GCGAAGGG	GAGAAGGG
GCCGGTCN	GCCGGGTC
GACTTTAA	GCTTTAAA
GCGAAGGT	GCGTAGGT
GCCGGTAA	ACCGGTAA
GCGAAGTA	GCAAAGTA
GCCGGTGT	GCCGGGTC
GCCGGTTC	GCCGGGTC
GCTTTNAA	GCTTTAAA
GCAATGTA	GCAAAGTA
GCCGGNGT	GCCGGGTC
GCAATTCT	GCACTTCT
GCCGGNTC	GCCGGGTC
GCAATTAG	ACAATTAG
GAACCCGC	AACCCGCG
GAACCCTC	GAATCCTC
GAACCCTG	GTACCCTG
GCNGGGTC	GCCGGGTC
GCGAGCCG	GAGAGCCG
GACTNACT	GACTAACT
GACTNAAC	GACTAACT
GCCGTAGG	GCGTAGGT
GCCGTAGT	GCCTTAGT
GCCGTGGT	GCCGGGTC
GACCGATA	GATCGATA
GCCGTGTC	GCCGGGTC
GAACCTCC	GAATCCTC
GAACCTCA	GAATCCTC
GAACCTCG	GAATCCTC
GAACCTCT	GAATCCTC
GAACCTCN	GAATCCTC
GCAANAGT	GCAAAGTA
GCCGTTAG	GCCTTAGT
GCCGTTGA	CCGTTGAG
GAACCTTT	AAACCTTT
GCGAGGTC	GCGTAGGT
GCGAGGTA	GCGTAGGT
GACCGGGT	GCCGGGTC
GCGAGGTG	GCGTAGGT
GCGAGGTT	GCGTAGGT
GCGAGGTN	GCGTAGGT
GACCGGTA	ACCGGTAA
GCAANGTA	GCAAAGTA
GCNGTAGG	GCGTAGGT
GAACAAGT	AAACAAGT
GACCTAAC	GACTAACT
GCGATAGG	GCGTAGGT
GCAGCTCA	CAGCTCAG
GCGATTAT	CGATTATT
GACCTTAG	GCCTTAGT
GCAGCTTC	GCACTTCT
GACNAACT	GACTAACT
GCGNAGGT	GCGTAGGT
GAACGATA	GATCGATA
GCAGAAAC	TCAGAAAC
GCAGAAGG	GAGAAGGG
GCAGAAGT	GCAAAGTA
GAACGGAT	GTACGGAT
GCAGAGCC	GAGAGCCG
GCAGAGTA	GCAAAGTA
GCNTCGCC	GCTCGCCC
GAACTCCT	GAATCCTC
GAACTAAC	GACTAACT
GCAGGGTC	GCCGGGTC
GCAGGTCT	TCAGGTCT
GCNTAGGT	GCGTAGGT
GACACTTC	GCACTTCT
GCGNTAGG	GCGTAGGT
GACNTAAC	GACTAACT
GCGGACAA	GTGGACAA
GAACTGTC	TGAACTGT
GAACTGTA	TGAACTGT
GAACTGTG	TGAACTGT
GAACTGTT	TGAACTGT
GAACTGTN	TGAACTGT
GCGGACTC	TGCGGACT
GCGGACTA	TGCGGACT
GCGGACTG	TGCGGACT
GCGGACTT	TGCGGACT
GCGGACTN	TGCGGACT
GAACTTCT	GCACTTCT
GCTTNAAA	GCTTTAAA
GCGGAAGC	CGCGGAAG
GAACTTGT	AACTTGTA
GCGGAAGA	CGCGGAAG
GCGGAAGG	CGCGGAAG
GCGGAAGT	CGCGGAAG
GACAACGC	ACAACGCG
GCGGAAGN	CGCGGAAG
GACAACTC	GACTAACT
GACAACTA	GACTAACT
GACAACTG	GACTAACT
GACAACTT	GACTAACT
GACAACTN	GACTAACT
GACAAACT	GACTAACT
GCGGAGGT	GCGTAGGT
GACAAAGT	GCAAAGTA
GCTTNTAA	GCTTTAAA
GACAAGCC	GTCAAGCC
GCGGATTC	CGGATTCC
GACAAGGG	GAGAAGGG
GACAATTA	ACAATTAG
GCNTTAAA	GCTTTAAA
GCNTTAGT	GCCTTAGT
GACAGCCG	GAGAGCCG
GCTNCGCC	GCTCGCCC
GCTCCCCC	GCTCGCCC
GCTCCCCA	GCTCGCCC
GCTCCCCG	GCTCGCCC
GCTCCCCT	GCTCGCCC
GCNTTTAA	GCTTTAAA
GCTCCCCN	GCTCGCCC
GCTCCCTT	GCCCCTTT
GATAACTC	GACTAACT
GATAACTA	GACTAACT
GATAACTG	GACTAACT
GATAACTT	GACTAACT
GATAACTN	GACTAACT
GCTCCGCC	GCTCGCCC
GAAACCTC	GAATCCTC
GAAACCTT	AAACCTTT
GCTCCGGG	TCTCCGGG
GATAAGGG	GAGAAGGG
GAAACAAG	AAACAAGT
GCTCCTTT	GCCCCTTT
GACATCCT	GAATCCTC
GACATCGT	ACATCGTT
GCTCACCC	GCTCGCCC
GACATAAC	GACTAACT
GATAGCCG	GAGAGCCG
GCAGTAGG	GCGTAGGT
GCTCAAGC	GTCAAGCC
GCTCAGCC	GCTCGCCC
GCTNGCCC	GCTCGCCC
GATAGATA	GATCGATA
GCAGTGTT	GAGTGTTC
GCAGTTCT	GCACTTCT
GAGCAAGG	GAGAAGGG
GCTCGCCC	GCTCGCCC
GCTCGCCA	GCTCGCCC
GCTCGCCG	GCTCGCCC
GCTCGCCT	GCTCGCCC
GCTCGCCN	GCTCGCCC
GCTCGCAC	GCTCGCCC
GAGTCCTC	GAATCCTC
GAGCAGCC	GAGAGCCG
GCTCGCGC	GCTCGCCC
GATATCCT	GAATCCTC
GCTCGCTC	GCTCGCCC
GAAAAGGG	GAGAAGGG
GAGCAGGC	AAGCAGGC
GCTCGCNC	GCTCGCCC
GAGCAGGG	GAGAAGGG
GCTCGACC	GCTCGCCC
GAAAAGTA	GCAAAGTA
GATATAAC	ATATAACT
GCTCGATA	GATCGATA
GCTCGATT	CCTCGATT
GCTCGGCC	GCTCGCCC
GAGTCGAT	GATCGATA
GCTCGGGT	GCCGGGTC
GAGTCGTT	GAGTGTTC
GCTCGTCC	GCTCGCCC
GCTNTAAA	GCTTTAAA
GAGCGCCG	GAGAGCCG
GAGTCTTC	GAGTGTTC
GAAAGCCA	CAAAGCCA
GAAAGCCG	GAGAGCCG
GATATTTC	ATATTTCC
GCTCGNCC	GCTCGCCC
GAGCGATA	GATCGATA
GCTNTTAA	GCTTTAAA
GCATCCGA	CATCCGAG
GCATCCTC	GAATCCTC
GAGCGTAA	TAGCGTAA
GAGTAACT	GACTAACT
GAAAGGAT	TAAAGGAT
GAAAGGGC	GAGAAGGG
GAAAGGGA	GAGAAGGG
GAGCGTTC	GAGTGTTC
GAAAGGGG	GAGAAGGG
GAAAGGGT	GAGAAGGG
GAGTAAGG	GAGAAGGG
GAGCGTTT	AGCGTTTC
GAAAGGGN	GAGAAGGG
GAGTAGCC	GAGAGCCG
GAAAGTAC	GCAAAGTA
GAAAGTAA	GCAAAGTA
GAAAGTAG	GCAAAGTA
GAAAGTAT	GCAAAGTA
GAAAGTAN	GCAAAGTA
GCATCGCC	GCTCGCCC
GAGTAGGG	GAGAAGGG
GAGTAGGT	GCGTAGGT
GAGTAGTT	GAGTGTTC
GCATCGAT	GATCGATA
GAGCTCAG	CAGCTCAG
GCATCGTT	ACATCGTT
GAGTATGG	TAGTATGG
GAGTATTC	GAGTGTTC
GAGCTAAC	GACTAACT
GCATCTTC	GCACTTCT
GAGTGCCG	GAGAGCCG
GAGCTGTT	GAGTGTTC
GAGTGCTC	GAGTGTTC
GAGTGCTT	GAGTGTTC
GATGCGAT	GATCGATA
GAGTGATC	GAGTGTTC
GAGTGATT	GAGTGTTC
GCNCCCTT	GCCCCTTT
GACGCTCC	ACGCTCCT
GCATAAGT	GCAAAGTA
GAGTGGTC	GAGTGTTC
GAGTGGTT	GAGTGTTC
GCATAGGT	GCGTAGGT
GAGTGTCC	GAGTGTTC
GAGTGTCA	GAGTGTTC
GCATAGTA	GCAAAGTA
GAGTGTCG	GAGTGTTC
GAGTGTCT	GAGTGTTC
GAGTGTCN	GAGTGTTC
GAGTGTAC	GAGTGTTC
GAGTGTAT	GAGTGTTC
GAGTGTGC	GAGTGTTC
GAGTGTGT	GAGTGTTC
GAGTGTTC	GAGTGTTC
GAGTGTTA	GAGTGTTC
GAGTGTTG	GAGTGTTC
GAGTGTTT	GAGTGTTC
GAGTGTTN	GAGTGTTC
GAGTGTNC	GAGTGTTC
GAGTGTNT	GAGTGTTC
GCNCCTTT	GCCCCTTT
GAGTGNTC	GAGTGTTC
GACGAACT	GACTAACT
GAGTGNTT	GAGTGTTC
GATTCCCG	GTTTCCCG
GACGAAGG	GAGAAGGG
GATGAAGG	GAGAAGGG
GACGAGCC	GAGAGCCG
GATTCCTC	GAATCCTC
GATTCCTG	ATTCCTGC
GATGAGCC	GAGAGCCG
GATTCAAG	ATTCAAGG
GACGATAC	GATCGATA
GACGATAA	GATCGATA
GAGACCCG	GAGAGCCG
GACGATAG	GATCGATA
GACGATAT	GATCGATA
GACGATAN	GATCGATA
GATGATAC	GATCGATA
GATGATAA	GATCGATA
GATGATAG	GATCGATA
GATGATAT	GATCGATA
GAGACCGC	GAGAGCCG
GATGATAN	GATCGATA
GAGACCGA	GAGAGCCG
GAGACCGG	GAGAGCCG
GAGACCGT	GAGAGCCG
GAGACCGN	GAGAGCCG
GAGTTGCC	AAGTTGCC
GATTCGAT	GATCGATA
GAGTTGTT	GAGTGTTC
GAGACAGG	GAGAAGGG
GAGTTTCC	GAGTGTTC
GAGTTTCA	GAGTGTTC
GAGTTTCG	GAGTGTTC
GAGTTTCT	GAGTGTTC
GAGTTTCN	GAGTGTTC
GAGACGCC	GAGAGCCG
GACGGCAT	CACGGCAT
GAGTTTTC	GAGTGTTC
GAGACGGG	GAGAAGGG
GATGGACA	GTGGACAA
GACGGATC	GTACGGAT
GACGGATA	GTACGGAT
GACGGATG	GTACGGAT
GACGGATT	GTACGGAT
GACGGATN	GTACGGAT
GATGGATA	GATCGATA
GAAATCCT	GAATCCTC
GACCCCTT	GCCCCTTT
GACGGGTC	GCCGGGTC
GAGAACCG	GAGAGCCG
GATGGTCA	AATGGTCA
GCATTCTC	GCACTTCT
GCATTCTA	GCACTTCT
GCATTCTG	GCACTTCT
GCATTCTT	GCACTTCT
GCATTCTN	GCACTTCT
GAGAACGG	GAGAAGGG
GCATTAAA	GCTTTAAA
GACCCGCG	AACCCGCG
GATTAACT	GACTAACT
GACCCGGC	CGACCCGG
GACCCGGA	CGACCCGG
GACCCGGG	CGACCCGG
GACCCGGT	CGACCCGG
GCATTAGT	GCCTTAGT
GACCCGGN	CGACCCGG
GAGAAAGG	GAGAAGGG
GAGAAATC	AAGAAATC
GAGAAGCC	GAGAGCCG
GAGAAGCG	GAGAAGGG
GAGTNGTT	GAGTGTTC
GACCCTGC	GTACCCTG
GACCCTGA	GTACCCTG
GAGAAGAG	GAGAAGGG
GACCCTGG	GTACCCTG
GACCCTGT	GTACCCTG
GACCCTGN	GTACCCTG
GAGAAGGC	GAGAAGGG
GAGAAGGA	GAGAAGGG
GAGAAGGG	GAGAAGGG
GACCCTTG	ACCCTTGG
GAGAAGGT	GAGAAGGG
GACCCTTT	GCCCCTTT
GAGAAGGN	GAGAAGGG
GATGTCGT	ATGTCGTA
GAGAAGTG	GAGAAGGG
GCATTTCT	GCACTTCT
GAGAAGNG	GAGAAGGG
GAGTNTTC	GAGTGTTC
GACGTAAC	GACTAACT
GCATTTAA	GCTTTAAA
GACGTAGG	GCGTAGGT
GAGAATGG	GAGAAGGG
GAGAGCCC	GAGAGCCG
GATTATTC	CGATTATT
GAGAGCCA	GAGAGCCG
GATTATTA	CGATTATT
GAGAGCCG	GAGAGCCG
GATTATTG	CGATTATT
GAGAGCCT	GAGAGCCG
GATTATTT	CGATTATT
GAGAGCCN	GAGAGCCG
GATTATTN	CGATTATT
GAGAGCAC	GAGAGCCG
GAGAGCAG	GAGAGCCG
GAGAGCGC	GAGAGCCG
GAGAGCGA	GAGAGCCG
GAGAGCGG	GAGAGCCG
GAGAGCGT	GAGAGCCG
GAGAGCGN	GAGAGCCG
GAGAGCTC	GAGAGCCG
GAGAANGG	GAGAAGGG
GAGAGCTG	GAGAGCCG
GAGAGCNC	GAGAGCCG
GACGTGTT	GAGTGTTC
GAGAGCNG	GAGAGCCG
GATGTGTT	GAGTGTTC
GAGAGACC	GAGAGCCG
GAGAGACG	GAGAGCCG
GATGTTCC	GAGTGTTC
GATGTTCA	GAGTGTTC
GATGTTCG	GAGTGTTC
GATGTTCT	GAGTGTTC
GATGTTCN	GAGTGTTC
GAGAGAGG	GAGAAGGG
GAGAGGCC	GAGAGCCG
GAGAGGCG	GAGAGCCG
GATTGCAT	GTTTGCAT
GAGAGGGC	GAGAAGGG
GAGAGGGA	GAGAAGGG
GAGAGGGG	GAGAAGGG
GAGAGGGT	GAGAAGGG
GAGAGGGN	GAGAAGGG
GAGAGTCC	GAGAGCCG
GAGAGTCG	GAGAGCCG
GAGAGTTC	GAGTGTTC
GANGTGTT	GAGTGTTC
GAGAGNCC	GAGAGCCG
GAGAGNCG	GAGAGCCG
GATTGATA	GATCGATA
GAGATCCG	GAGAGCCG
GAGATCCT	GAATCCTC
GAAGCCGC	GAGAGCCG
GAAGCCGA	GAGAGCCG
GAAGCCGG	GAGAGCCG
GAAGCCGT	GAGAGCCG
GAAGCCGN	GAGAGCCG
GAAGCCTC	GAATCCTC
GAGATAGG	GAGAAGGG
GAGATGCC	GAGAGCCG
GAAGCAGG	AAGCAGGC
GATTGTTC	GAGTGTTC
GAGATGGG	GAGAAGGG
GAGATGTT	GAGTGTTC
GAGNAAGG	GAGAAGGG
GAGNAGCC	GAGAGCCG
GACTCCTC	GAATCCTC
GAGNAGGG	GAGAAGGG
GACTCACT	GACTAACT
GACTCAAC	GACTAACT
GAGANCCG	GAGAGCCG
GACTCGCC	GCTCGCCC
GATTTCCC	GTTTCCCG
GACTCGAT	GATCGATA
GAGANAGG	GAGAAGGG
GANTCCTC	GAATCCTC
GAAGAAAT	AAGAAATC
GAGANGCC	GAGAGCCG
GAAGAAGG	GAGAAGGG
GAGNGCCG	GAGAGCCG
GAGANGGG	GAGAAGGG
GAAGAGCC	GAGAGCCG
GATTTAAA	GCTTTAAA
GCANCTTC	GCACTTCT
GANTCGAT	GATCGATA
GACTACCT	GACTAACT
GACTACAC	GACTAACT
GATTTGCA	GTTTGCAT
GACTACTC	GACTAACT
GACTACTA	GACTAACT
GACTACTG	GACTAACT
GACTACTT	GACTAACT
GACTACTN	GACTAACT
GACTAACC	GACTAACT
GACTAACA	GACTAACT
GACTAACG	GACTAACT
GCNCGCCC	GCTCGCCC
GACTAACT	GACTAACT
GACTAACN	GACTAACT
GACTAAAC	GACTAACT
GACTAAAT	GACTAACT
GACTAAGC	GACTAACT
GACTAAGT	GACTAACT
GACTAATC	GACTAACT
GACTAATA	GACTAACT
GACTAATG	GACTAACT
GACTAATT	GACTAACT
GACTAATN	GACTAACT
GACTAANC	GACTAACT
GACTAANT	GACTAACT
GAGGCCGC	GAGAGCCG
GAGGCCGA	GAGAGCCG
GAGGCCGG	GAGAGCCG
GAGGCCGT	GAGAGCCG
GAGGCCGN	GAGAGCCG
GACTAGCT	GACTAACT
GACTAGAC	GACTAACT
GAGNGTTC	GAGTGTTC
GACTATCT	GACTAACT
GACTATAC	GACTAACT
GANTAACT	GACTAACT
GCNCGGGT	GCCGGGTC
GACTANCT	GACTAACT
GACTANAC	GACTAACT
GAAGGGAG	AAGGGAGT
GAGGACAA	GTGGACAA
GAAGTCCT	GAATCCTC
GAGNTGTT	GAGTGTTC
GAGGAAGG	GAGAAGGG
GAGGAGCC	GAGAGCCG
GAGGAGGG	GAGAAGGG
GCNCTTCT	GCACTTCT
GCNCTTAG	GCCTTAGT
GAAGTGTT	GAGTGTTC
GAAGTTGC	AAGTTGCC
GANTGTTC	GAGTGTTC
GAGGGCCA	AGGGCCAA
GAGGGCCG	GAGAGCCG
GATNCGAT	GATCGATA
GAGGGAGT	AAGGGAGT
GGCACTTC	GCACTTCT
GAGGGTCG	AGGGTCGG
GAGGGTTC	GAGTGTTC
GATCCCTC	TGATCCCT
GATCCCTA	TGATCCCT
GATCCCTG	TGATCCCT
GATCCCTT	TGATCCCT
GATCCCTN	TGATCCCT
GGACCCGG	CGACCCGG
GGACCCTG	GTACCCTG
GATCCATA	GATCGATA
GGCAAAGT	GCAAAGTA
GATCCGAG	CATCCGAG
GATCCGAT	GATCGATA
GAATCCCC	GAATCCTC
GAATCCCA	GAATCCTC
GAATCCCG	GAATCCTC
GAATCCCT	GAATCCTC
GAATCCCN	GAATCCTC
GAATCCAC	GAATCCTC
GAATCCAT	GAATCCTC
GGCAAGCC	GTCAAGCC
GAATCCGC	GAATCCTC
GAATCCGT	GAATCCTC
GAATCCTC	GAATCCTC
GATCCTCC	GAATCCTC
GAATCCTA	GAATCCTC
GATCCTCA	GAATCCTC
GAATCCTG	GAATCCTC
GATCCTCG	GAATCCTC
GAATCCTT	GAATCCTC
GATCCTCT	GAATCCTC
GAATCCTN	GAATCCTC
GATCCTCN	GAATCCTC
GAATCCNC	GAATCCTC
GAATCCNT	GAATCCTC
GAATCACT	GAATCCTC
GAATCATC	GAATCCTC
GAGGTGTT	GAGTGTTC
GAATCGCT	GAATCCTC
GAATCGAG	TAATCGAG
GAATCGAT	GATCGATA
GAGGTTCC	GAGTGTTC
GAGGTTCA	GAGTGTTC
GAGGTTCG	GAGTGTTC
GAGGTTCT	GAGTGTTC
GAGGTTCN	GAGTGTTC
GAATCGTC	GAATCCTC
GAATCTCC	GAATCCTC
GAATCTCA	GAATCCTC
GAATCTCG	GAATCCTC
GAATCTCT	GAATCCTC
GAATCTCN	GAATCCTC
GCNACTTC	GCACTTCT
GAATCTTC	GAATCCTC
GATCAAGC	GTCAAGCC
GAATCNCT	GAATCCTC
GGACTAAC	GACTAACT
GATCAATA	GATCGATA
GAATCNTC	GAATCCTC
GATCAGAT	GATCGATA
GATCATAC	GATCGATA
GATCATAA	GATCGATA
GATCATAG	GATCGATA
GATCATAT	GATCGATA
GATCATAN	GATCGATA
GGACTTCT	GCACTTCT
GCNAAAGT	GCAAAGTA
GATNGATA	GATCGATA
GATCGCCC	GCTCGCCC
GCNAAGTA	GCAAAGTA
GATCGCAT	GATCGATA
GATCGCTA	GATCGATA
GATCGACA	GATCGATA
GATCGACT	GATCGATA
GATCGAAC	GATCGATA
GATCGAAA	GATCGATA
GATCGAAG	GATCGATA
GATCGAAT	GATCGATA
GATCGAAN	GATCGATA
GATCGAGA	GATCGATA
GATCGAGT	GATCGATA
GATCGATC	GATCGATA
GATCGATA	GATCGATA
GATCGATG	GATCGATA
GATCGATT	GATCGATA
GATCGATN	GATCGATA
GATCGANA	GATCGATA
GATCGANT	GATCGATA
GATCGGAT	GATCGATA
GATCGGTA	GATCGATA
GGGCGCAT	TGGCGCAT
GGACGGAT	GTACGGAT
GATCGTAC	GATCGATA
GATCGTAA	GATCGATA
GATCGTAG	GATCGATA
GATCGTAT	GATCGATA
GATCGTAN	GATCGATA
GATCGTTA	GATCGATA
GATCGNAT	GATCGATA
GATCGNTA	GATCGATA
GATCTAAC	GACTAACT
GATCTATA	GATCGATA
GATCTGAC	ATCTGACC
GATCTGAT	GATCGATA
GGAACTGT	TGAACTGT
GATCNATA	GATCGATA
GATCNGAT	GATCGATA
GGAAAGTA	GCAAAGTA
GGCGCATC	TGGCGCAT
GGCGCATA	TGGCGCAT
GGCGCATG	TGGCGCAT
GGCGCATT	TGGCGCAT
GGCGCATN	TGGCGCAT
GATACCCT	GTACCCTG
GATACGAT	GATCGATA
GATACGGA	GTACGGAT
GAATACCT	GAATCCTC
GGAAGGGC	GAGAAGGG
GGAAGGGA	GAGAAGGG
GGAAGGGG	GAGAAGGG
GGAAGGGT	GAGAAGGG
GGAAGGGN	GAGAAGGG
GAATACTC	GAATCCTC
GGGACAAC	GTGGACAA
GGGACAAA	GTGGACAA
GGGACAAG	GTGGACAA
GGGACAAT	GTGGACAA
GGGACAAN	GTGGACAA
GAATAACT	GACTAACT
GGAATCCT	GAATCCTC
GAATATAT	TAATATAT
GGCGGACT	TGCGGACT
GGCGGAAG	CGCGGAAG
GGTGGACA	GTGGACAA
GGCCCCTT	GCCCCTTT
GGCGGGTC	GCCGGGTC
GAATGCCT	GAATCCTC
GGTGGGGT	TGTGGGGT
GAATGCTC	GAATCCTC
GANCGATA	GATCGATA
GGTGGTTC	CGGTGGTT
GGTGGTTA	CGGTGGTT
GGTGGTTG	CGGTGGTT
GGTGGTTT	CGGTGGTT
GGTGGTTN	CGGTGGTT
GGGAAGGG	GAGAAGGG
GGCCCTTT	GCCCCTTT
GAATGGTC	AATGGTCA
GGCGTAGG	GCGTAGGT
GGGAGCCG	GAGAGCCG
GAATGTTC	GAGTGTTC
GGCGTTTC	AGCGTTTC
GANCTAAC	GACTAACT
GGTGTTCC	GAGTGTTC
GGTGTTCA	GAGTGTTC
GGTGTTCG	GAGTGTTC
GGTGTTCT	GAGTGTTC
GGTGTTCN	GAGTGTTC
GAATTCCT	GAATCCTC
GAATTCTC	GAATCCTC
GGCCGGGT	GCCGGGTC
GGAGCCGC	GAGAGCCG
GGAGCCGA	GAGAGCCG
GGAGCCGG	GAGAGCCG
GGAGCCGT	GAGAGCCG
GGAGCCGN	GAGAGCCG
GAATNCCT	GAATCCTC
GGGATTCC	CGGATTCC
GAATNCTC	GAATCCTC
GGTTCCCG	GTTTCCCG
GGCTCGCC	GCTCGCCC
GGAGAAGG	GAGAAGGG
GGTTGCAT	GTTTGCAT
GGAGAGCC	GAGAGCCG
GGCCTTAG	GCCTTAGT
GAANCCTC	GAATCCTC
GGCTAACT	GACTAACT
GGGGCCAA	AGGGCCAA
GGTTTCCC	GTTTCCCG
GGTTTAAA	GCTTTAAA
GGTTTGCA	GTTTGCAT
GGGGACAA	GTGGACAA
GGTTTTGA	TGTTTTGA
GGAGTGTT	GAGTGTTC
GGCTTAGT	GCCTTAGT
GGCTTTAA	GCTTTAAA
GAANTCCT	GAATCCTC
GTACCCCG	GTACCCTG
GTACCCCT	GTACCCTG
GTACCCAG	GTACCCTG
GTACCCAT	GTACCCTG
GTACCCGC	GTACCCTG
GTACCCGA	GTACCCTG
GTACCCGG	GTACCCTG
GTACCCGT	GTACCCTG
GTACCCGN	GTACCCTG
GTACCCTC	GTACCCTG
GTACCCTA	GTACCCTG
GTACCCTG	GTACCCTG
GTACCCTT	GTACCCTG
GTACCCTN	GTACCCTG
GTACCCNG	GTACCCTG
GTACCCNT	GTACCCTG
GGGGTCGG	AGGGTCGG
GTACCACC	TACCACCA
GTACCACT	GTACCCTG
GTACCATG	GTACCCTG
GGATCCCT	TGATCCCT
GTACCGCT	GTACCCTG
GGATCCTC	GAATCCTC
GTACCGAT	GTACGGAT
GTACCGGA	GTACGGAT
GTACCGTG	GTACCCTG
GTACCTCT	GTACCCTG
GTACCTGC	GTACCCTG
GTACCTGA	GTACCCTG
GTACCTGG	GTACCCTG
GTACCTGT	GTACCCTG
GTACCTGN	GTACCCTG
GTACCTTG	GTACCCTG
GGATCGAT	GATCGATA
GTACCNCT	GTACCCTG
GTACCNTG	GTACCCTG
GGTCAAGC	GTCAAGCC
GTACACCT	GTACCCTG
GTACACTG	GTACCCTG
GTACAAGC	GTCAAGCC
GTACAGAT	GTACGGAT
GTACAGGA	GTACGGAT
GGTCGCCC	GCTCGCCC
GTACGCCT	GTACCCTG
GGTCGATA	GATCGATA
GTACGCAT	GTACGGAT
GTACGCGA	GTACGGAT
GTACGCTG	GTACCCTG
GTACGAAT	GTACGGAT
GTACGAGA	GTACGGAT
GTACGATC	GTACGGAT
GTACGATA	GTACGGAT
GTACGATG	GTACGGAT
GTACGATT	GTACGGAT
GTACGATN	GTACGGAT
GTCAGCCC	GTCAAGCC
GTCAGCCA	GTCAAGCC
GANAAGGG	GAGAAGGG
GTCAGCCG	GTCAAGCC
GTCAGCCT	GTCAAGCC
GTCAGCCN	GTCAAGCC
GTACGGCA	GTACGGAT
GTACGGCT	GTACGGAT
GTACGGAC	GTACGGAT
GTACGGAA	GTACGGAT
GTACGGAG	GTACGGAT
GTACGGAT	GTACGGAT
GTACGGAN	GTACGGAT
GTACGGGA	GTACGGAT
GTACGGGT	GTACGGAT
GTACGGTC	GTACGGAT
GTACGGTA	GTACGGAT
GTACGGTG	GTACGGAT
GTACGGTT	GTACGGAT
GTACGGTN	GTACGGAT
GGGTCGGC	AGGGTCGG
GTACGGNA	GTACGGAT
GGGTCGGA	AGGGTCGG
GGGTCGGG	AGGGTCGG
GTACGGNT	GTACGGAT
GGGTCGGT	AGGGTCGG
GGGTCGGN	AGGGTCGG
GTCAGAAA	TCAGAAAC
GTACGTAT	GTACGGAT
GTCAGAGC	GTCAAGCC
GTACGTGA	GTACGGAT
GTCAGGCC	GTCAAGCC
GTACGNAT	GTACGGAT
GTACGNGA	GTACGGAT
GTCAGGTC	TCAGGTCT
GANAGCCG	GAGAGCCG
GTACTCCT	GTACCCTG
GTACTCTG	GTACCCTG
GTACTAAC	GACTAACT
GGATTCCC	CGGATTCC
GGATTCCA	CGGATTCC
GGATTCCG	CGGATTCC
GGATTCCT	CGGATTCC
GGATTCCN	CGGATTCC
GTACTGAT	GTACGGAT
GTACTGGA	GTACGGAT
GGGTAGGT	GCGTAGGT
GGATTATT	CGATTATT
GTACTTCT	GCACTTCT
GTCATAGC	GTCAAGCC
GTCATGCC	GTCAAGCC
GANATCCT	GAATCCTC
GTACNCCT	GTACCCTG
GTACNCTG	GTACCCTG
GGGTGGTT	CGGTGGTT
GTACNGAT	GTACGGAT
GTACNGGA	GTACGGAT
GGTACCCT	GTACCCTG
GGGTGTTC	GAGTGTTC
GTCANAGC	GTCAAGCC
GTCANGCC	GTCAAGCC
GTGACCCT	GTACCCTG
GTAACCCC	TTAACCCC
GTAACCCT	GTACCCTG
GGTACGGA	GTACGGAT
GTAACCTG	GTACCCTG
GTGACAAC	GTGGACAA
GTGACAAA	GTGGACAA
GTGACAAG	GTGGACAA
GTGACAAT	GTGGACAA
GTGACAAN	GTGGACAA
GTGACGGA	GTACGGAT
GTAACGGA	GTACGGAT
GTCGCCCC	GCTCGCCC
GTCGCCCA	GCTCGCCC
GTCGCCCG	GCTCGCCC
GTCGCCCT	GCTCGCCC
GTCGCCCN	GCTCGCCC
GTAAAGCC	GTCAAGCC
GTAAAGGA	TAAAGGAT
GTAAAGTA	GCAAAGTA
GTGAACAA	GTGGACAA
GTCCCCTG	GTACCCTG
GTCCCCTT	GCCCCTTT
GTTGGCAT	GTTTGCAT
GTGAACTG	TGAACTGT
GTTGGACA	GTGGACAA
GTGAAGCC	GTCAAGCC
GTAAGCCC	GTCAAGCC
GTAAGCCA	GTCAAGCC
GTAAGCCG	GTCAAGCC
GTAAGCCT	GTCAAGCC
GTAAGCCN	GTCAAGCC
GTGAAGGG	GAGAAGGG
GTCCCTGC	GTACCCTG
GTCCCTGA	GTACCCTG
GTAAGAAC	CTAAGAAC
GTCCCTGG	GTACCCTG
GTCCCTGT	GTACCCTG
GTCCCTGN	GTACCCTG
GTCCCTTT	GCCCCTTT
GTCGACAA	GTGGACAA
GTAAGGAT	GTACGGAT
GTGAGCCG	GAGAGCCG
GTCGAAGC	GTCAAGCC
GTTGTCCC	GTTTCCCG
GTCGAGCC	GTCAAGCC
GTCCAACG	TCCAACGA
GTGAGACA	GTGGACAA
GGTAGGTC	GCGTAGGT
GGTAGGTA	GCGTAGGT
GGTAGGTG	GCGTAGGT
GGTAGGTT	GCGTAGGT
GGTAGGTN	GCGTAGGT
GTCCAAGC	GTCAAGCC
GTTGTAAG	TTGTAAGC
GTCCAGCC	GTCAAGCC
GTCGATAC	GATCGATA
GTCGATAA	GATCGATA
GTCGATAG	GATCGATA
GTAATCCT	GAATCCTC
GTCGATAT	GATCGATA
GTCGATAN	GATCGATA
GTTGTGCA	GTTTGCAT
GTAATCGA	TAATCGAG
GTTGTGGC	TTTGTGGC
GANGAAGG	GAGAAGGG
GTGAGTTA	TTGAGTTA
GTAATATA	TAATATAT
GANGAGCC	GAGAGCCG
GTCGGCAG	TTCGGCAG
GGTATACG	CGTATACG
GTGATCCC	TGATCCCT
GTCGGACA	GTGGACAA
GTCCGCTA	TCCGCTAG
GTCGGATC	GTACGGAT
GTCGGATA	GTACGGAT
GTCGGATG	GTACGGAT
GTCGGATT	GTACGGAT
GTCGGATN	GTACGGAT
GTCGGGTC	GCCGGGTC
GTCCGGAT	GTACGGAT
GTCCGGGT	GCCGGGTC
GTCTCCCG	GTTTCCCG
GTCTCCGG	TCTCCGGG
GTTTCCCC	GTTTCCCG
GTTTCCCA	GTTTCCCG
GTTTCCCG	GTTTCCCG
GTTTCCCT	GTTTCCCG
GTCTCGCC	GCTCGCCC
GTTTCCCN	GTTTCCCG
GTTTCCAC	GTTTCCCG
GTTTCCAG	GTTTCCCG
GTTTCCAT	GTTTGCAT
GTTTCCGC	GTTTCCCG
GTTTCCGA	GTTTCCCG
GTTTCCGG	GTTTCCCG
GTTTCCGT	GTTTCCCG
GTTTCCGN	GTTTCCCG
GTTTCCTC	GTTTCCCG
GTTTCCTG	GTTTCCCG
GTTTCCNC	GTTTCCCG
GTTTCCNG	GTTTCCCG
GTTTCACC	GTTTCCCG
GTCGTAGG	GCGTAGGT
GTTTCACG	GTTTCCCG
GTTTCATC	GTTTGCAT
GTTTCATA	GTTTGCAT
GTTTCATG	GTTTGCAT
GTTTCATT	GTTTGCAT
GTTTCATN	GTTTGCAT
GTAGCCCT	GTACCCTG
GTTTCGCC	GTTTCCCG
GTTTCGCA	GTTTGCAT
GTTTCGCG	GTTTCCCG
GTAGCCTG	GTACCCTG
GTCCTTCA	TCCTTCAC
GTCCTTAG	GCCTTAGT
GTTTCTCC	GTTTCCCG
GTTTCTCG	GTTTCCCG
GTCTACAT	TTCTACAT
GTAGCATT	CTAGCATT
GTTTCNCC	GTTTCCCG
GTTTCNCG	GTTTCCCG
GTCTAACT	GACTAACT
GTAGCGGA	GTACGGAT
GTAGCGTA	TAGCGTAA
GTCTAAGC	GTCAAGCC
GTGGCCAA	GTGGACAA
GTTTACCC	GTTTCCCG
GTTTACCG	GTTTCCCG
GTCTAGCC	GTCAAGCC
GTTTACAT	GTTTGCAT
GTGGCACA	GTGGACAA
GTGGCAAC	GTGGACAA
GTGGCAAA	GTGGACAA
GTGGCAAG	GTGGACAA
GTGGCAAT	GTGGACAA
GTGGCAAN	GTGGACAA
GTTTAAAC	GCTTTAAA
GTTTAAAA	GCTTTAAA
GTTTAAAG	GCTTTAAA
GTTTAAAT	GCTTTAAA
GTTTAAAN	GCTTTAAA
GTGGCGCA	TGGCGCAT
GTTTAGCA	GTTTGCAT
GTAGACAA	GTGGACAA
GTAGAAGG	GAGAAGGG
GTCTGCAT	GTTTGCAT
GTAGAGCC	GAGAGCCG
GTCTGACC	ATCTGACC
GTGGACCA	GTGGACAA
GTCACCCT	GTACCCTG
GTGGACAC	GTGGACAA
GTGGACAA	GTGGACAA
GTGGACAG	GTGGACAA
GTGGACAT	GTGGACAA
GTGGACAN	GTGGACAA
GTTTGCCC	GTTTCCCG
GTGGACGA	GTGGACAA
GTTTGCCA	GTTTGCAT
GTTTGCCG	GTTTCCCG
GTTTGCCT	GTTTGCAT
GTTTGCAC	GTTTGCAT
GTGGACTA	GTGGACAA
GTTTGCAA	GTTTGCAT
GTTTGCAG	GTTTGCAT
GTTTGCAT	GTTTGCAT
GTTTGCAN	GTTTGCAT
GTGGACNA	GTGGACAA
GTTTGCGA	GTTTGCAT
GTTTGCGT	GTTTGCAT
GTTTGCTC	GTTTGCAT
GTGGAACA	GTGGACAA
GTTTGCTA	GTTTGCAT
GTTTGCTG	GTTTGCAT
GTTTGCTT	GTTTGCAT
GTTTGCTN	GTTTGCAT
GTGGAAAC	GTGGACAA
GTGNACAA	GTGGACAA
GTGGAAAA	GTGGACAA
GTTTGCNA	GTTTGCAT
GTGGAAAG	GTGGACAA
GTTTGCNT	GTTTGCAT
GTGGAAAT	GTGGACAA
GTGGAAAN	GTGGACAA
GTTTGACA	GTTTGCAT
GTCACAGC	GTCAAGCC
GTTTGAAT	GTTTGCAT
GTTTGATC	GTTTGCAT
GTTTGATA	GTTTGCAT
GTGGAGCA	GTGGACAA
GTTTGATG	GTTTGCAT
GTCACGCC	GTCAAGCC
GTTTGATT	GTTTGCAT
GTTTGATN	GTTTGCAT
GTGGAGAA	GTGGACAA
GTAGGCCC	CTAGGCCC
GTTTGGCA	GTTTGCAT
GTCACGGA	GTACGGAT
GTTTGGAT	GTTTGCAT
GTGGATCA	GTGGACAA
GTGGATAA	GTGGACAA
GTAGGACA	GTGGACAA
GTTTGTCA	GTTTGCAT
GTCTTCCC	GTTTCCCG
GTCACTTC	GCACTTCT
GTTTGTAT	GTTTGCAT
GTAGGATC	GTACGGAT
GTTTGTGG	TTTGTGGC
GTAGGATA	GTACGGAT
GTAGGATG	GTACGGAT
GTAGGATT	GTACGGAT
GTAGGATN	GTACGGAT
GTGGANCA	GTGGACAA
GTGGANAA	GTGGACAA
GTTTGNCA	GTTTGCAT
GTAGGGAT	GTACGGAT
GTTTGNAT	GTTTGCAT
GTCAACCC	GTCAAGCC
GTCAACCA	GTCAAGCC
GTCTTAGT	GCCTTAGT
GTCAACCG	GTCAAGCC
GTCAACCT	GTCAAGCC
GTGGGCAA	GTGGACAA
GTCAACCN	GTCAAGCC
GTTTTCCC	GTTTCCCG
GTCAACGC	GTCAAGCC
GTTTTCCG	GTTTCCCG
GTCTTGCA	GTTTGCAT
GTTTTCAT	GTTTGCAT
GTGGGACA	GTGGACAA
GTCTTGGA	TCTTGGAG
GTCAAACC	GTCAAGCC
GTCAAAGC	GTCAAGCC
GTGGGATC	CTGGGATC
GTTTTAAA	GCTTTAAA
GTCAAAGT	GCAAAGTA
GTCTTTAA	GCTTTAAA
GTCAAGCC	GTCAAGCC
GTCAAGCA	GTCAAGCC
GTCAAGCG	GTCAAGCC
GTCAAGCT	GTCAAGCC
GTCAAGCN	GTCAAGCC
GTCAAGAC	GTCAAGCC
GTTTTGCA	GTTTGCAT
GTCAAGGC	GTCAAGCC
GTGGGGTC	TGTGGGGT
GTTTTGAC	TGTTTTGA
GTGGGGTA	TGTGGGGT
GTTTTGAA	TGTTTTGA
GTGGGGTG	TGTGGGGT
GTTTTGAG	TGTTTTGA
GTGGGGTT	TGTGGGGT
GTTTTGAT	TGTTTTGA
GTGGGGTN	TGTGGGGT
GTGNGACA	GTGGACAA
GTTTTGAN	TGTTTTGA
GTCAAGTC	GTCAAGCC
GTCAAGNC	GTCAAGCC
GTCAATCC	GTCAAGCC
GTCAATGC	GTCAAGCC
GTAGTATG	TAGTATGG
GTCAANCC	GTCAAGCC
GTCAANGC	GTCAAGCC
GTAGTGTT	GAGTGTTC
GTTTNCCC	GTTTCCCG
GTGGTCAA	GTGGACAA
GTTTNCCG	GTTTCCCG
GTTTNCAT	GTTTGCAT
GTGGTACA	GTGGACAA
GTATCCCG	GTTTCCCG
GTATCCCT	GTACCCTG
GTTNCCCG	GTTTCCCG
GTTTNGCA	GTTTGCAT
GTATCCTC	GAATCCTC
GTATCCTG	GTACCCTG
GTATCGAT	GATCGATA
GTATCGGA	GTACGGAT
GTGGNCAA	GTGGACAA
GTGGNACA	GTGGACAA
GTATACGC	CGTATACG
GTATACGA	CGTATACG
GTATACGG	CGTATACG
GTATACGT	CGTATACG
GTATACGN	CGTATACG
GTATAACT	ATATAACT
GTCNAAGC	GTCAAGCC
GTGTCCCG	GTTTCCCG
GTCNAGCC	GTCAAGCC
GTATGCAT	GTTTGCAT
GTTNGCAT	GTTTGCAT
GNACGGAT	GTACGGAT
GTGTCGTA	ATGTCGTA
GTTCCCCG	GTTTCCCG
GTTCCCGC	GTTTCCCG
GTTCCCGA	GTTTCCCG
GTTCCCGG	GTTTCCCG
GTTCCCGT	GTTTCCCG
GTTCCCGN	GTTTCCCG
GTTCCCTG	GTACCCTG
GGGCCAAC	AGGGCCAA
GGGCCAAA	AGGGCCAA
GGGCCAAG	AGGGCCAA
GGGCCAAT	AGGGCCAA
GGGCCAAN	AGGGCCAA
GTATGGAT	GTACGGAT
GTGTACAA	GTGGACAA
GTGTAAGC	TTGTAAGC
GNACTAAC	GACTAACT
GTTCCTGC	ATTCCTGC
GTATTCCC	GTTTCCCG
GTGTAGGT	GCGTAGGT
GNACTTCT	GCACTTCT
GTTNTCCC	GTTTCCCG
GTATTGCA	GTTTGCAT
GTATTTCC	ATATTTCC
GTTCAAGC	GTCAAGCC
GTTCAAGG	ATTCAAGG
GTGTGCAT	GTTTGCAT
GTGTGACA	GTGGACAA
GTTNTGCA	GTTTGCAT
GTGTGGGG	TGTGGGGT
GTTACCCG	GTTTCCCG
GTTACCCT	GTACCCTG
GTTACCAA	CTTACCAA
GTGTGTTC	GAGTGTTC
GTTCGCCC	GCTCGCCC
GTTCGCAT	GTTTGCAT
GTGTTCCC	GTTTCCCG
GTTACGGA	GTACGGAT
GTTCGATA	GATCGATA
GTTCGGCA	TTCGGCAG
GTTCGGAT	GTACGGAT
GTGTTGCA	GTTTGCAT
GTANCCCT	GTACCCTG
GTANCCTG	GTACCCTG
GTTAACCC	TTAACCCC
GTGTTTTG	TGTTTTGA
GTANCGGA	GTACGGAT
GTTCTCCC	GTTTCCCG
GNCCCCTT	GCCCCTTT
GTTAAGCC	GTCAAGCC
GTTCTCTA	CTTCTCTA
GTNCCCTG	GTACCCTG
GTTCTACA	TTCTACAT
GTTAATGC	CTTAATGC
GTTCTGCA	GTTTGCAT
GNAAAGTA	GCAAAGTA
GNCCCTTT	GCCCCTTT
GTTAGCAT	GTTTGCAT
GTNCAAGC	GTCAAGCC
GTTATCCC	GTTTCCCG
GTTATGCA	GTTTGCAT
GNAATCCT	GAATCCTC
GTNCGGAT	GTACGGAT
GNCCGGGT	GCCGGGTC
GNTTCCCG	GTTTCCCG
GTNACCCT	GTACCCTG
GTTGCCCG	GTTTCCCG
GNCCTTAG	GCCTTAGT
GTTGCACG	TTGCACGA
GNCGGGTC	GCCGGGTC
GTTGCATC	GTTTGCAT
GTTGCATA	GTTTGCAT
GTTGCATG	GTTTGCAT
GTTGCATT	GTTTGCAT
GTNACGGA	GTACGGAT
GTTGCATN	GTTTGCAT
GTTGACAA	GTGGACAA
GNCGTAGG	GCGTAGGT
GTNAAGCC	GTCAAGCC
GNGGACAA	GTGGACAA
GNTTGCAT	GTTTGCAT
GTTGAGTT	TTGAGTTA
GNAGAAGG	GAGAAGGG
GNAGAGCC	GAGAGCCG
GNCACTTC	GCACTTCT
GNCTTAGT	GCCTTAGT
GNTTTCCC	GTTTCCCG
GNCTTTAA	GCTTTAAA
GNCAAAGT	GCAAAGTA
GNTTTAAA	GCTTTAAA
GNCAAGCC	GTCAAGCC
GNTTTGCA	GTTTGCAT
GNCTCGCC	GCTCGCCC
GTANGGAT	GTACGGAT
GNAGTGTT	GAGTGTTC
GNCTAACT	GACTAACT
GTGCCCTG	GTACCCTG
GNATCCTC	GAATCCTC
GNGTAGGT	GCGTAGGT
GNATCGAT	GATCGATA
GTGCACAA	GTGGACAA
GTGCACGA	TTGCACGA
GTGCAAGC	GTCAAGCC
GNGTGTTC	GAGTGTTC
TCAACCCC	TTAACCCC
GTGCGACA	GTGGACAA
GTGCGGAC	TGCGGACT
GTGCGGAT	GTACGGAT
GNTCAAGC	GTCAAGCC
TCAACGCG	ACAACGCG
TCAACGAC	TCCAACGA
TCAACGAA	TCCAACGA
TCAACGAG	TCCAACGA
TCAACGAT	TCCAACGA
TCAACGAN	TCCAACGA
TCAACTGT	TGAACTGT
TCCCCACT	CCCCACTG
GNTCGCCC	GCTCGCCC
TCAAACGA	TCCAACGA
TCCCCGGG	TCTCCGGG
GNACCCTG	GTACCCTG
TCAAAACC	TCAGAAAC
TCAAAACA	TCAGAAAC
TCAAAACG	TCAGAAAC
TCAAAACT	TCAGAAAC
TCAAAACN	TCAGAAAC
TCAAAAAC	TCAGAAAC
TCCCCTAA	CCCCTAAA
TCCCCTAG	TCCGCTAG
TCCCCTTT	GCCCCTTT
TCAAAGCC	CAAAGCCA
GNTCGATA	GATCGATA
TCAAAGGA	TAAAGGAT
TCAAAGTA	GCAAAGTA
TCCCACCA	TACCACCA
TCAAATGG	CCAAATGG
TCCCACGA	TCCAACGA
TCCCACTG	CCCCACTG
TCCCAACG	TCCAACGA
TCAAGCCC	GTCAAGCC
TCAAGCCA	GTCAAGCC
TCAAGCCG	GTCAAGCC
TCAAGCCT	GTCAAGCC
TCAAGCCN	GTCAAGCC
TCCCAGTT	CCCAGTTA
TCCCATCC	CCCATCCA
TCAAGAAA	TCAGAAAC
TCAAGGAT	TAAAGGAT
TCAAGGTC	TCAGGTCT
TCAAGTCT	TCAGGTCT
TCCCGCTA	TCCGCTAG
GTNGACAA	GTGGACAA
TCCCGGGC	TCTCCGGG
TCCCGGGA	TCTCCGGG
TCCCGGGG	TCTCCGGG
TCAATCGA	TAATCGAG
TCCCGGGT	TCTCCGGG
TCCCGGGN	TCTCCGGG
TCAATATA	TAATATAT
TCCCTCAC	TCCTTCAC
TCAATTAG	ACAATTAG
TCCCTAAA	CCCCTAAA
TCCCTAGC	TCCGCTAG
TCCCTAGA	TCCGCTAG
TCCCTAGG	TCCGCTAG
TCCCTAGT	TCCGCTAG
TCCCTAGN	TCCGCTAG
GTNGGACA	GTGGACAA
TCCCTGTC	CCCTGTCG
TCCCTTCA	TCCTTCAC
TCCCTTGG	ACCCTTGG
GNTACCCT	GTACCCTG
GNTACGGA	GTACGGAT
TCAGCAAC	TCAGAAAC
TCAGCAAA	TCAGAAAC
TCAGCGTC	TCAGGTCT
TCAGCGTA	TAGCGTAA
TCAGCTCA	CAGCTCAG
TCAGCTCT	TCAGGTCT
TCGGACTC	TGCGGACT
TCAGCTAG	TCCGCTAG
TCGGACTA	TGCGGACT
TCGGACTG	TGCGGACT
TCGGACTT	TGCGGACT
TCGGACTN	TGCGGACT
TCCACCAC	TACCACCA
TCCACCAA	TACCACCA
TCCACCAG	TACCACCA
TCCACCAT	TACCACCA
TCCACCAN	TACCACCA
TCCACCGA	TCCAACGA
TCGGAAAC	TCAGAAAC
TCCACACG	TCCAACGA
TCAGACAC	TCAGAAAC
TCAGACAA	TCAGAAAC
TCCACGAC	TCCAACGA
TCCACGAA	TCCAACGA
TCCACGAG	TCCAACGA
TCCACGAT	TCCAACGA
TCCACGAN	TCCAACGA
TCAGAACC	TCAGAAAC
TCAGAACA	TCAGAAAC
TCAGAACG	TCAGAAAC
TCAGAACT	TCAGAAAC
TCAGAACN	TCAGAAAC
TCAGAAAC	TCAGAAAC
TCGGATTC	CGGATTCC
TCAGAAAA	TCAGAAAC
TCAGAAAG	TCAGAAAC
TCAGAAAT	TCAGAAAC
TCAGAAAN	TCAGAAAC
TCAGAAGC	TCAGAAAC
TCAGAAGA	TCAGAAAC
TCCACTAG	TCCGCTAG
TCAGAATC	TCAGAAAC
TCAGAATA	TCAGAAAC
TCAGAANC	TCAGAAAC
TCAGAANA	TCAGAAAC
TCAGAGAC	TCAGAAAC
TCAGAGAA	TCAGAAAC
TCAGAGTC	TCAGGTCT
TCCGTCAC	TCCTTCAC
TCAGATCT	TCAGGTCT
TCCGTCTA	TCCGCTAG
TCAGATAC	TCAGAAAC
TCAGATAA	TCAGAAAC
TCCAACCA	TCCAACGA
TCCAACCG	TCCAACGA
TCCAACAC	TCCAACGA
GTNTCCCG	GTTTCCCG
TCCAACAA	TCCAACGA
TCCAACAG	TCCAACGA
TCCAACAT	TCCAACGA
TCCAACAN	TCCAACGA
TCCAACGC	TCCAACGA
TCCAACGA	TCCAACGA
TCCAACGG	TCCAACGA
TCCAACGT	TCCAACGA
TCCAACGN	TCCAACGA
TCCAACTA	TCCAACGA
TCCAACTG	TCCAACGA
TCCGTAGC	TCCGCTAG
TCCGTAGA	TCCGCTAG
TCCAACNA	TCCAACGA
TCCGTAGG	TCCGCTAG
TCCAACNG	TCCAACGA
TCCGTAGT	TCCGCTAG
TCCGTAGN	TCCGCTAG
TCAGANAC	TCAGAAAC
TCAGANAA	TCAGAAAC
TCCAAACG	TCCAACGA
TCCAAAGA	TCCAACGA
TCCAAATG	CCAAATGG
TCTTTCAC	TCCTTCAC
TCCAAGCG	TCCAACGA
TCCAAGAC	TCCAACGA
TCCAAGAA	TCCAACGA
TCCAAGAG	TCCAACGA
TCGGGTCT	TCAGGTCT
TCCAAGAT	TCCAACGA
TCCAAGAN	TCCAACGA
TCCAAGGA	TCCAACGA
GNTGGACA	GTGGACAA
TCCGTTCA	TCCTTCAC
TCCGTTAG	TCCGCTAG
TCCGTTGA	CCGTTGAG
TCCAATCG	TCCAACGA
TCTTTAAA	GCTTTAAA
TCCAATGA	TCCAACGA
TCCAANCG	TCCAACGA
TCTTTGAG	TCTTGGAG
TCCAANGA	TCCAACGA
TCTTTGGA	TCTTGGAG
TCGGTCTC	TCAGGTCT
TCGGTCTA	TCAGGTCT
TCGGTCTG	TCAGGTCT
TCGGTCTT	TCAGGTCT
TCGGTCTN	TCAGGTCT
TCCAGCGA	TCCAACGA
TCCGNCTA	TCCGCTAG
TCTTTTGA	TGTTTTGA
TCCAGCTA	TCCGCTAG
TCCAGACG	TCCAACGA
TCCAGAAA	TCAGAAAC
TCGGTGGT	CGGTGGTT
TCCAGGTC	TCAGGTCT
TCCGNTAG	TCCGCTAG
TCCAGTTA	CCCAGTTA
TCTTNGAG	TCTTGGAG
TCCATCCA	CCCATCCA
TCTTNGGA	TCTTGGAG
TCCATCAC	TCCTTCAC
TCCATCGA	TCCAACGA
GTNTGCAT	GTTTGCAT
TCCTCCAC	TCCTTCAC
TCCTCCGG	TCTCCGGG
TCCATACG	TCCAACGA
TCCTCACC	TCCTTCAC
TCCTCACA	TCCTTCAC
TCCTCACG	TCCTTCAC
TCCTCACT	TCCTTCAC
TCCTCACN	TCCTTCAC
TCAGGCCT	TCAGGTCT
TCAGGCTC	TCAGGTCT
TCAGGCTA	TCAGGTCT
TCAGGCTG	TCAGGTCT
TCAGGCTT	TCAGGTCT
TCAGGCTN	TCAGGTCT
TCCTCGAT	CCTCGATT
TCCATTCA	TCCTTCAC
TCTNCCGG	TCTCCGGG
TCAGGACT	TCAGGTCT
TCAGGAAC	TCAGAAAC
TCAGGAAA	TCAGAAAC
TCAGGATC	TCAGGTCT
TCCTCTCA	TCCTTCAC
TCCTCTAG	TCCGCTAG
TCAGGGCT	TCAGGTCT
TCGTCCGG	TCTCCGGG
TCAGGGTC	TCAGGTCT
GTNTTCCC	GTTTCCCG
TCAGGTCC	TCAGGTCT
TCAGGTCA	TCAGGTCT
TCTNCGGG	TCTCCGGG
TCAGGTCG	TCAGGTCT
TCAGGTCT	TCAGGTCT
TCAGGTCN	TCAGGTCT
TCAGGTAC	TCAGGTCT
TCCANCGA	TCCAACGA
TCAGGTAT	TCAGGTCT
TCAGGTGC	TCAGGTCT
TCAGGTGT	TCAGGTCT
TCAGGTTC	TCAGGTCT
TCAGGTTA	TCAGGTCT
TCAGGTTG	TCAGGTCT
TCAGGTTT	TCAGGTCT
TCAGGTTN	TCAGGTCT
TCAGGTNC	TCAGGTCT
TCCANACG	TCCAACGA
TCAGGTNT	TCAGGTCT
TCCTACAC	TCCTTCAC
TCAGGNCT	TCAGGTCT
TCCTACAT	TTCTACAT
TCCTACGA	TCCAACGA
TCCNACGA	TCCAACGA
TCAGGNTC	TCAGGTCT
GTNTTGCA	GTTTGCAT
TCCTAACG	TCCAACGA
TCCNAACG	TCCAACGA
TCAGTCTC	TCAGGTCT
TCAGTCTA	TCAGGTCT
TCAGTCTG	TCAGGTCT
TCAGTCTT	TCAGGTCT
TCAGTCTN	TCAGGTCT
TCAGTAAC	TCAGAAAC
TCAGTAAA	TCAGAAAC
TCAGTATG	TAGTATGG
TCCTATCA	TCCTTCAC
TCAGTGTC	TCAGGTCT
TCCGCCAG	TCCGCTAG
TCGTAAGC	TTGTAAGC
TCAGTTCT	TCAGGTCT
TCCGCCTA	TCCGCTAG
TCCGCAAG	TCCGCTAG
TCCGCAGC	TCCGCTAG
TCCGCAGA	TCCGCTAG
TCGTAGGT	GCGTAGGT
TCCGCAGG	TCCGCTAG
TCCGCAGT	TCCGCTAG
TCCGCAGN	TCCGCTAG
TCCGCATA	TCCGCTAG
TCCTGCAC	TCCTTCAC
TCCTGCAA	CCTGCAAG
TCCNGCTA	TCCGCTAG
TCGTATAC	CGTATACG
TCCGCGAG	TCCGCTAG
TCCTGCTA	TCCGCTAG
TCGTATGG	TAGTATGG
TCCGCGTA	TCCGCTAG
TCCGCTCA	TCCGCTAG
TCCGCTCG	TCCGCTAG
TCCGCTAC	TCCGCTAG
TCCGCTAA	TCCGCTAG
TCCGCTAG	TCCGCTAG
TCCGCTAT	TCCGCTAG
TCCGCTAN	TCCGCTAG
TCCGCTGC	TCCGCTAG
TCCGCTGA	TCCGCTAG
TCAGNAAC	TCAGAAAC
TCCGCTGG	TCCGCTAG
TCAGNAAA	TCAGAAAC
TCCGCTGT	TCCGCTAG
TCCGCTGN	TCCGCTAG
TCCGCTTA	TCCGCTAG
TCCGCTTG	TCCGCTAG
TCCGCTNA	TCCGCTAG
TCCGCTNG	TCCGCTAG
TCCTGGAG	TCTTGGAG
TCCGCNAG	TCCGCTAG
TCCGCNTA	TCCGCTAG
TCAGNGTC	TCAGGTCT
TCTNGGAG	TCTTGGAG
TCCTGTCA	TCCTTCAC
TCCTGTCG	CCCTGTCG
TCAGNTCT	TCAGGTCT
TCCGACGA	TCCAACGA
TCCGACTA	TCCGCTAG
TCCGAACG	TCCAACGA
TCGTGGAG	TCTTGGAG
TCCGAAAC	TCAGAAAC
TCGTGGGG	TGTGGGGT
TCCNTCAC	TCCTTCAC
TCCTTCCC	TCCTTCAC
TCCTTCCA	TCCTTCAC
TCCTTCCG	TCCTTCAC
TCCTTCCT	TCCTTCAC
TCCTTCCN	TCCTTCAC
TCCTTCAC	TCCTTCAC
TCATCCCT	TGATCCCT
TCCTTCAA	TCCTTCAC
TCCTTCAG	TCCTTCAC
TCCTTCAT	TCCTTCAC
TCCTTCAN	TCCTTCAC
TCCTTCGC	TCCTTCAC
TCCTTCGA	TCCTTCAC
TCATCCGA	CATCCGAG
TCATCCGG	TCTCCGGG
TCCTTCTC	TCCTTCAC
TCCTTCTA	TCCTTCAC
TCCTTCNC	TCCTTCAC
TCCTTCNA	TCCTTCAC
TCCGATAG	TCCGCTAG
TCCTTACC	TCCTTCAC
TCCTTACA	TCCTTCAC
TCCTTACG	TCCTTCAC
TCCTTACT	TCCTTCAC
TCCTTACN	TCCTTCAC
TCCTTAAC	TCCTTCAC
TCCTTAGT	GCCTTAGT
TCGTTCAC	TCCTTCAC
TCCNTTCA	TCCTTCAC
TCCTTGCA	TCCTTCAC
TCATCGAG	TAATCGAG
TCCTTGAC	TCCTTCAC
TCCTTGGA	TCTTGGAG
TCATCGTT	ACATCGTT
TCTNTGGA	TCTTGGAG
TCCGGCAG	TTCGGCAG
TCCGGCTA	TCCGCTAG
TCCTTTCA	TCCTTCAC
TCCTTTAC	TCCTTCAC
TCGTTGAG	CCGTTGAG
TCCGGACT	TGCGGACT
TCGTTGGA	TCTTGGAG
TCCTTNCA	TCCTTCAC
TCCTTNAC	TCCTTCAC
TCGTTTTG	TGTTTTGA
TCCGGGTC	GCCGGGTC
TCCTNCAC	TCCTTCAC
TCCGGTCT	TCAGGTCT
TCCGGTAA	ACCGGTAA
TCCGGTAG	TCCGCTAG
TCATAAAC	TCAGAAAC
TACCCCCA	TACCACCA
TACCCCAC	TACCACCA
TACCCCAA	TACCACCA
TACCCCAG	TACCACCA
TACCCCAT	TACCACCA
TACCCCAN	TACCACCA
TACCCACC	TACCACCA
TCATATAT	TAATATAT
TACCCGCG	AACCCGCG
TCCTNTCA	TCCTTCAC
TACCCTGC	GTACCCTG
TACCCTGA	GTACCCTG
TACCCTGG	GTACCCTG
TACCCTGT	GTACCCTG
TACCCTGN	GTACCCTG
TCACCACC	TACCACCA
TACCCTTG	ACCCTTGG
TCATGAAA	TCAGAAAC
TACCACCC	TACCACCA
TACCACCA	TACCACCA
TACCACCG	TACCACCA
TCACCGGG	TCTCCGGG
TACCACCT	TACCACCA
TACCACCN	TACCACCA
TACCACAC	TACCACCA
TACCACAA	TACCACCA
TACCACAG	TACCACCA
TACCACAT	TACCACCA
TACCACAN	TACCACCA
TACCACGC	TACCACCA
TACCACGA	TACCACCA
TACCACTC	TACCACCA
TACCACTA	TACCACCA
TACCACNC	TACCACCA
TACCACNA	TACCACCA
TCATGGAG	TCTTGGAG
TACCAACC	TACCACCA
TACCAACA	TACCACCA
TACCAACG	TCCAACGA
TCATGGTC	TCAGGTCT
TCNCCGGG	TCTCCGGG
TCANAAAC	TCAGAAAC
TCATGTCT	TCAGGTCT
TACCAGCC	TACCACCA
TACCAGCA	TACCACCA
TACCATCC	TACCACCA
TACCATCA	TACCACCA
TCCNCTAG	TCCGCTAG
TCACAACG	TCCAACGA
TCACAAAC	TCAGAAAC
TAAAGCCA	CAAAGCCA
TCATTCAC	TCCTTCAC
TACCANCC	TACCACCA
TACCANCA	TACCACCA
TAAAGCAT	TAAAGGAT
TAAAGCGA	TAAAGGAT
TACCGCCA	TACCACCA
TAAAGAAT	TAAAGGAT
TCTCGCCC	GCTCGCCC
TAAAGAGA	TAAAGGAT
TAAAGATC	TAAAGGAT
TAAAGATA	TAAAGGAT
TAAAGATG	TAAAGGAT
TAAAGATT	TAAAGGAT
TAAAGATN	TAAAGGAT
TACCGCTA	TCCGCTAG
TCTCGCGG	TCTCCGGG
TAAAGGCA	TAAAGGAT
TCTCGCTA	TCCGCTAG
TAAAGGCT	TAAAGGAT
TACCGACC	TACCACCA
TAAAGGAC	TAAAGGAT
TAAAGGAA	TAAAGGAT
TAAAGGAG	TAAAGGAT
TAAAGGAT	TAAAGGAT
TAAAGGAN	TAAAGGAT
TCATTGGA	TCTTGGAG
TAAAGGGA	TAAAGGAT
TAAAGGGT	TAAAGGAT
TAAAGGTC	TAAAGGAT
TAAAGGTA	TAAAGGAT
TAAAGGTG	TAAAGGAT
TAAAGGTT	TAAAGGAT
TAAAGGTN	TAAAGGAT
TAAAGGNA	TAAAGGAT
TAAAGGNT	TAAAGGAT
TCANGAAA	TCAGAAAC
TAAAGTAT	TAAAGGAT
TCTCGATT	CCTCGATT
TAAAGTGA	TAAAGGAT
TCTCGGCA	TTCGGCAG
TACCGGTA	ACCGGTAA
TCTCGGAG	TCTTGGAG
TCTCGGGC	TCTCCGGG
TCTCGGGA	TCTCCGGG
TCTCGGGG	TCTCCGGG
TCTCGGGT	TCTCCGGG
TCTCGGGN	TCTCCGGG
TAAAGNAT	TAAAGGAT
TCACGCTA	TCCGCTAG
TACCGTAA	TAGCGTAA
TAAAGNGA	TAAAGGAT
TCANGGTC	TCAGGTCT
TCACGAAA	TCAGAAAC
TCANGTCT	TCAGGTCT
TAAATCGA	TAATCGAG
TCACGGCA	CACGGCAT
TACCTCCA	TACCACCA
TCACGGTC	TCAGGTCT
TAAATATC	TAATATAT
TAAATATA	TAATATAT
TAAATATG	TAATATAT
TAAATATT	TAATATAT
TAAATATN	TAATATAT
TCACGTCT	TCAGGTCT
TACCTACC	TACCACCA
TAAATGAT	TAAAGGAT
TAAATGGA	TAAAGGAT
TCTCTCGG	TCTCCGGG
TCTCTACA	TTCTACAT
TACCTTCA	TCCTTCAC
TCTCTGGA	TCTTGGAG
GNGAAGGG	GAGAAGGG
TCTCTGGG	TCTCCGGG
TCTCTTCA	TCCTTCAC
TACCNCCA	TACCACCA
TCNCAACG	TCCAACGA
TCACTTCA	TCCTTCAC
TCACTTCT	GCACTTCT
TACCNACC	TACCACCA
TAAANGAT	TAAAGGAT
TAAANGGA	TAAAGGAT
GNGAGCCG	GAGAGCCG
TCTCNCGG	TCTCCGGG
TCTGCCGG	TCTCCGGG
TCTGCACG	TTGCACGA
TCTGCAAG	CCTGCAAG
TCTCNGGG	TCTCCGGG
TCTGCGGG	TCTCCGGG
TACACCAC	TACCACCA
TACACCAA	TACCACCA
TAAGCAGG	AAGCAGGC
TACACCAG	TACCACCA
TACACCAT	TACCACCA
TACACCAN	TACCACCA
TCTGCTAG	TCCGCTAG
TACACACC	TACCACCA
TAAGCGAG	TAATCGAG
TAAGCGTA	TAGCGTAA
TCTGACCC	ATCTGACC
TCTACCGG	TCTCCGGG
TCTGACCA	ATCTGACC
TCTGACCG	ATCTGACC
TCTGACCT	ATCTGACC
TCTGACCN	ATCTGACC
TCTGAAAC	TCAGAAAC
TCTACATC	TTCTACAT
TCTACATA	TTCTACAT
TCGCCGGG	TCTCCGGG
TCTACATG	TTCTACAT
TCTACATT	TTCTACAT
TCTACATN	TTCTACAT
TAAGAACC	CTAAGAAC
TAAGAACA	CTAAGAAC
TAAGAACG	CTAAGAAC
TCTACGGG	TCTCCGGG
TAAGAACT	CTAAGAAC
TAAGAACN	CTAAGAAC
TAAGAAAC	TCAGAAAC
TACAACCA	TACCACCA
TAAGAAAT	AAGAAATC
TCNCGCTA	TCCGCTAG
TCTGAGTT	TTGAGTTA
TACAACGC	ACAACGCG
TACAACGA	TCCAACGA
TAAGAGGA	TAAAGGAT
TCTCCCGG	TCTCCGGG
TCGCACGA	TTGCACGA
TAAGATAT	TAATATAT
TACAAGGA	TAAAGGAT
TCTAACCC	TTAACCCC
TCGCAACG	TCCAACGA
TCTCCAGG	TCTCCGGG
TCTAACGA	TCCAACGA
TCTCCGCG	TCTCCGGG
TCTCCGAG	TCTCCGGG
TCTCCGGC	TCTCCGGG
TCTCCGGA	TCTCCGGG
TCTCCGGG	TCTCCGGG
TACAATTA	ACAATTAG
TCTCCGGT	TCTCCGGG
TCTCCGGN	TCTCCGGG
TCTCCGTG	TCTCCGGG
TCTGGAGC	TCTTGGAG
TCTCCGNG	TCTCCGGG
TCTGGAGA	TCTTGGAG
TCTGGAGG	TCTTGGAG
TCTGGAGT	TCTTGGAG
TCTGGAGN	TCTTGGAG
TCTCCTGG	TCTCCGGG
TCTGGGAG	TCTTGGAG
TCTGGGAT	CTGGGATC
TCTAAGAA	CTAAGAAC
TCTGGGGT	TGTGGGGT
TAAGGATC	TAAAGGAT
TAAGGATA	TAAAGGAT
TAAGGATG	TAAAGGAT
TAAGGATT	TAAAGGAT
TAAGGATN	TAAAGGAT
TCTCCNGG	TCTCCGGG
TCTGGTCT	TCAGGTCT
TAAGGGAG	AAGGGAGT
TAAGGGAT	TAAAGGAT
TACAGAAA	TCAGAAAC
TCTCACGG	TCTCCGGG
TAAGGTCT	TCAGGTCT
TCGCGCAT	TGGCGCAT
TCNCTTCA	TCCTTCAC
TCGCGCTA	TCCGCTAG
TCTCAACG	TCCAACGA
TACAGGAT	TAAAGGAT
TACAGGTC	TCAGGTCT
TCTAGCAT	CTAGCATT
TCTCAGGG	TCTCCGGG
TCGCGGAC	TGCGGACT
TCGCGGAA	CGCGGAAG
TCTGTAAG	TTGTAAGC
TAAGTCGA	TAATCGAG
TCTAGAAA	TCAGAAAC
TCGCGTAA	TAGCGTAA
TCTGTGGC	TTTGTGGC
TCTGTGGA	TCTTGGAG
TCTAGGCC	CTAGGCCC
TAAGTATA	TAATATAT
TAAGTATG	TAGTATGG
TCTAGGAG	TCTTGGAG
TCTAGGTC	TCAGGTCT
TACATCGA	TAATCGAG
TACATCGT	ACATCGTT
TAAGTTGC	AAGTTGCC
TACATATA	TAATATAT
TCTATGGA	TCTTGGAG
TAGTCATG	TAGTATGG
TAGTCGAG	TAATCGAG
TAGTCGTA	TAGCGTAA
TCTTCCGG	TCTCCGGG
TAGTCTGG	TAGTATGG
TCTTCACC	TCCTTCAC
TCTTCACA	TCCTTCAC
TCTTCACG	TCCTTCAC
TCTTCACT	TCCTTCAC
TCTTCACN	TCCTTCAC
TCNAACGA	TCCAACGA
TCTTCGAG	TCTTGGAG
TCTTCGGA	TCTTGGAG
TCTTCGGG	TCTCCGGG
TCNGCTAG	TCCGCTAG
TAGTACGG	TAGTATGG
TCTTCTCT	CTTCTCTA
TAGTACTG	TAGTATGG
TAGTAAGC	TTGTAAGC
TAGTAAGG	TAGTATGG
TAGTAATG	TAGTATGG
TACGCACC	TACCACCA
TAGTAGGC	TAGTATGG
TAGTAGGA	TAGTATGG
TAGTAGGG	TAGTATGG
TAGTAGGT	TAGTATGG
TAGTAGGN	TAGTATGG
TCTTACCA	CTTACCAA
TAGTAGTG	TAGTATGG
TCNGAAAC	TCAGAAAC
TAGTATCG	TAGTATGG
TAGTATAG	TAGTATGG
TAGTATAT	TAATATAT
TAGTATGC	TAGTATGG
TAGTATGA	TAGTATGG
TAGTATGG	TAGTATGG
TAGTATGT	TAGTATGG
TAGTATGN	TAGTATGG
TAGTATTG	TAGTATGG
TACGCGTA	TAGCGTAA
TAGTATNG	TAGTATGG
TACGCTCC	ACGCTCCT
TCTTAATG	CTTAATGC
TACGCTAG	TCCGCTAG
TAGTANGG	TAGTATGG
TAGTANTG	TAGTATGG
TCTTAGAG	TCTTGGAG
TACTACCA	TACCACCA
TCTTAGGA	TCTTGGAG
TACTACAT	TTCTACAT
TCNAGAAA	TCAGAAAC
TACTAACT	GACTAACT
TACGACCA	TACCACCA
TAGTGATG	TAGTATGG
TCNAGGTC	TCAGGTCT
TAGTGGGG	TGTGGGGT
TCTTGCAG	TCTTGGAG
TCTTGCGA	TCTTGGAG
TAGTGTAA	TAGCGTAA
TACTATAT	TAATATAT
TAGTGTGG	TAGTATGG
TAGTGTTC	GAGTGTTC
TACTATGG	TAGTATGG
TCTTGAAG	TCTTGGAG
TCTTGAGC	TCTTGGAG
TCTTGAGA	TCTTGGAG
TCTTGAGG	TCTTGGAG
TCTTGAGT	TCTTGGAG
TCTTGAGN	TCTTGGAG
TCTTGGCA	TCTTGGAG
TCTTGGCG	TCTTGGAG
TCTTGGAC	TCTTGGAG
TCTTGGAA	TCTTGGAG
TCTTGGAG	TCTTGGAG
TCTTGGAT	TCTTGGAG
TCTTGGAN	TCTTGGAG
TCTTGGGC	TCTTGGAG
TCTTGGGA	TCTTGGAG
TCTTGGGG	TCTTGGAG
TCTTGGGT	TCTTGGAG
TCTTGGGN	TCTTGGAG
TCNGGTCT	TCAGGTCT
TCTTGGTA	TCTTGGAG
TCTTGGTG	TCTTGGAG
TCTTGGNA	TCTTGGAG
TCTTGGNG	TCTTGGAG
TCTTGTAG	TCTTGGAG
TCTTGTGA	TCTTGGAG
TCTTGTGG	TTTGTGGC
TACGGCAG	TTCGGCAG
TACGGCAT	CACGGCAT
TAGTTATG	TAGTATGG
TCTTGNAG	TCTTGGAG
TCTTGNGA	TCTTGGAG
TAGTTGCC	AAGTTGCC
TACGGACT	TGCGGACT
TAGTTGGC	TAGTATGG
TAGTTGGA	TAGTATGG
TAGTTGGG	TAGTATGG
TAGTTGGT	TAGTATGG
TAGTTGGN	TAGTATGG
TACGGATC	GTACGGAT
TACGGATA	GTACGGAT
TACGGATG	GTACGGAT
TACGGATT	GTACGGAT
TACGGATN	GTACGGAT
TAGTTTGG	TAGTATGG
TAGTTTTG	TGTTTTGA
TAATCCCT	TGATCCCT
TAATCCAG	TAATCGAG
TAATCCGA	TAATCGAG
TAATCCTC	GAATCCTC
TAATCAAG	TAATCGAG
TAATCAGC	TAATCGAG
TAATCAGA	TAATCGAG
TAATCAGG	TAATCGAG
TAATCAGT	TAATCGAG
TAATCAGN	TAATCGAG
TAATCATA	TAATATAT
TACTTCAC	TCCTTCAC
TAATCGCA	TAATCGAG
TAATCGCG	TAATCGAG
TAATCGAC	TAATCGAG
TAATCGAA	TAATCGAG
TAATCGAG	TAATCGAG
TAGTNATG	TAGTATGG
TAATCGAT	TAATCGAG
TAATCGAN	TAATCGAG
TAATCGGC	TAATCGAG
TAATCGGA	TAATCGAG
TAATCGGG	TAATCGAG
TAATCGGT	TAATCGAG
TAATCGGN	TAATCGAG
TAATCGTA	TAATCGAG
TAATCGTG	TAATCGAG
TAATCGNA	TAATCGAG
TAATCGNG	TAATCGAG
TACGTAAC	TAGCGTAA
TACGTAAA	TAGCGTAA
TACGTAAG	TAGCGTAA
TACGTAAT	TAGCGTAA
TACGTAAN	TAGCGTAA
TAATCTAG	TAATCGAG
TAACCCCC	TTAACCCC
TAATCTAT	TAATATAT
TAACCCCA	TTAACCCC
TAACCCCG	TTAACCCC
TAACCCCT	TTAACCCC
TAATCTGA	TAATCGAG
TAACCCCN	TTAACCCC
TACGTATG	TAGTATGG
TAACCCGC	AACCCGCG
TAGTNTGG	TAGTATGG
TAATCNAG	TAATCGAG
TAACCACC	TACCACCA
TACTTGGA	TCTTGGAG
TAATCNGA	TAATCGAG
TACTTGTA	AACTTGTA
TANCCACC	TACCACCA
TCGCTCCT	ACGCTCCT
TAATACAT	TAATATAT
TAATACGA	TAATCGAG
TAACCGAG	TAATCGAG
TAATACTA	TAATATAT
TAATAAAT	TAATATAT
TCGCTAGC	TCCGCTAG
TAATAATC	TAATATAT
TCGCTAGA	TCCGCTAG
TAATAATA	TAATATAT
TCGCTAGG	TCCGCTAG
TAATAATG	TAATATAT
TCGCTAGT	TCCGCTAG
TAATAATT	TAATATAT
TCGCTAGN	TCCGCTAG
TAATAATN	TAATATAT
TAACCTTT	AAACCTTT
TAATAGAG	TAATCGAG
TAATAGAT	TAATATAT
TAATAGGA	TAAAGGAT
TAATAGTA	TAATATAT
TAATATCA	TAATATAT
TAATATCT	TAATATAT
TAATATAC	TAATATAT
TAGNCGTA	TAGCGTAA
TCGCTTCA	TCCTTCAC
TAATATAA	TAATATAT
TAACACCA	TACCACCA
TCNTCCGG	TCTCCGGG
TAATATAG	TAATATAT
TAATATAT	TAATATAT
TAATATAN	TAATATAT
TAATATGA	TAATATAT
TAATATGG	TAGTATGG
TAATATGT	TAATATAT
TAATATTC	TAATATAT
TAATATTA	TAATATAT
TAATATTG	TAATATAT
TAATATTT	TAATATAT
TAATATTN	TAATATAT
TAATATNA	TAATATAT
TAATATNT	TAATATAT
TANCACCA	TACCACCA
TAATANAT	TAATATAT
TAATANTA	TAATATAT
TAACAAGT	AAACAAGT
TAATGCGA	TAATCGAG
TAACAGGA	TAAAGGAT
TAATGAGC	TAATCGAG
TAATGAGA	TAATCGAG
TAATGAGG	TAATCGAG
TAACATAT	TAATATAT
TAATGAGT	TAATCGAG
TAATGAGN	TAATCGAG
TAATGATA	TAATATAT
TAATGGAG	TAATCGAG
TAATGGAT	TAAAGGAT
TACTCCGG	TCTCCGGG
TAATGGTC	AATGGTCA
TACTCACC	TACCACCA
TAATGTAT	TAATATAT
TACNCACC	TACCACCA
TAGNATGG	TAGTATGG
TACTCGAG	TAATCGAG
TAACGAGC	TAATCGAG
TAACGAGA	TAATCGAG
TAACGAGG	TAATCGAG
TAACGAGT	TAATCGAG
TAACGAGN	TAATCGAG
TCGACCCG	CGACCCGG
TAACGGAT	TAAAGGAT
TAATTCGA	TAATCGAG
TAACGTAA	TAGCGTAA
TANCGTAA	TAGCGTAA
TAATTATC	TAATATAT
TAATTATA	TAATATAT
TAATTATG	TAATATAT
TAATTATT	TAATATAT
TAATTATN	TAATATAT
TAATTGAG	TAATCGAG
TAANTCGA	TAATCGAG
TACNACCA	TACCACCA
TGCCTTCA	TCCTTCAC
TAACTCGA	TAATCGAG
TGCCTTAG	GCCTTAGT
TAATTTAT	TAATATAT
TAANTATA	TAATATAT
TAACTATA	TAATATAT
TAGNGTAA	TAGCGTAA
TAACTGTC	TGAACTGT
TAACTGTA	TGAACTGT
TAACTGTG	TGAACTGT
TAACTGTT	TGAACTGT
TAACTGTN	TGAACTGT
TAACTTGT	AACTTGTA
TCGAACGA	TCCAACGA
TCGAACTG	TGAACTGT
TCGAAACC	TCAGAAAC
TCGAAACA	TCAGAAAC
TCGAAACG	TCAGAAAC
TAATNCGA	TAATCGAG
TCGAAACT	TCAGAAAC
TCGAAACN	TCAGAAAC
TAGNTATG	TAGTATGG
TGAGCCCT	TGATCCCT
TAATNATA	TAATATAT
TAATNGAG	TAATCGAG
TGAGCGCA	TGGCGCAT
TAATNTAT	TAATATAT
TGAGCGTA	TAGCGTAA
TGAGCTGT	TGAACTGT
TGCACGAC	TTGCACGA
TGCACGAA	TTGCACGA
TGCACGAG	TTGCACGA
TGCACGAT	TTGCACGA
TGCACGAN	TTGCACGA
TAAACCCC	TTAACCCC
TAAACCTT	AAACCTTT
TGCACTGT	TGAACTGT
TGCACTTC	GCACTTCT
TCGAGAAA	TCAGAAAC
TAAACAAG	AAACAAGT
TAGCCACC	TACCACCA
TGAGACTG	TGAACTGT
TGAGAAAC	TCAGAAAC
TAAACGAG	TAATCGAG
TAAACGAT	TAAAGGAT
TAAACGGA	TAAAGGAT
TGAGAAGG	GAGAAGGG
TCGAGGTC	TCAGGTCT
TAANCGAG	TAATCGAG
TGCAACGA	TCCAACGA
TAGCCGTA	TAGCGTAA
TGAGAGCC	GAGAGCCG
TGCAACTG	TGAACTGT
TAAACTGT	TGAACTGT
TAGCCTAA	TAGCGTAA
TCGAGTTA	TTGAGTTA
TGCAAAGT	GCAAAGTA
TATCCCTC	TGATCCCT
TATCCCTA	TGATCCCT
TATCCCTG	TGATCCCT
TATCCCTT	TGATCCCT
TATCCCTN	TGATCCCT
TATCCACC	TACCACCA
TCGATCCC	TGATCCCT
TAGCACCA	TACCACCA
TAGCACGA	TTGCACGA
TATCCGAG	CATCCGAG
TATCCGGG	TCTCCGGG
TGAGGACT	TGCGGACT
TAAAAGAT	TAAAGGAT
TAAAAGGA	TAAAGGAT
TAGCAGGC	AAGCAGGC
TAAAATAT	TAATATAT
TAGCAGTA	TAGCGTAA
TAANAGGA	TAAAGGAT
TGAGGGGT	TGTGGGGT
TGCAGACT	TGCGGACT
TGCAGAAA	TCAGAAAC
TCGATTAT	CGATTATT
TAGCATAA	TAGCGTAA
TATCACCA	TACCACCA
TGAGGTCT	TCAGGTCT
TAGCATGG	TAGTATGG
TAGCATTC	CTAGCATT
TAGCATTA	CTAGCATT
TAGCATTG	CTAGCATT
TAGCATTT	CTAGCATT
TAGCATTN	CTAGCATT
TGCAGGAC	TGCGGACT
TAANATAT	TAATATAT
TGCAGGTC	TCAGGTCT
TATGTCGT	ATGTCGTA
TGAGTCCC	TGATCCCT
TAGCGCAA	TAGCGTAA
TAGCGCAT	TGGCGCAT
TATGTAAG	TTGTAAGC
TAGCGCTA	TAGCGTAA
TATGTATG	TAGTATGG
TAGCGAAC	TAGCGTAA
TAGCGAAA	TAGCGTAA
TAGCGAAG	TAGCGTAA
TAGCGAAT	TAGCGTAA
TAGCGAAN	TAGCGTAA
TATGTGGC	TTTGTGGC
TGCATCCC	TGATCCCT
TAGCGATA	TAGCGTAA
TATAACCC	TTAACCCC
TGAGTATG	TAGTATGG
TAGCGGAC	TGCGGACT
TAGCGGAA	TAGCGTAA
TATAACTC	ATATAACT
TATAACTA	ATATAACT
TATAACTG	ATATAACT
TATAACTT	ATATAACT
TATAACTN	ATATAACT
TAGCGGTA	TAGCGTAA
TGAGTGTT	GAGTGTTC
TAANGGAT	TAAAGGAT
TAGCGTCA	TAGCGTAA
TAGCGTAC	TAGCGTAA
TAGCGTAA	TAGCGTAA
TAGCGTAG	TAGCGTAA
TGAGTTAC	TTGAGTTA
TAGCGTAT	TAGCGTAA
TGAGTTAA	TTGAGTTA
TAGCGTAN	TAGCGTAA
TGAGTTAG	TTGAGTTA
TGAGTTAT	TTGAGTTA
TAGCGTGA	TAGCGTAA
TGAGTTAN	TTGAGTTA
TAGCGTTA	TAGCGTAA
TAGCGTTT	AGCGTTTC
TAGCGTNA	TAGCGTAA
TAGCGNAA	TAGCGTAA
TATAAGGA	TAAAGGAT
TATCGAGC	TAATCGAG
TATCGAGA	TAATCGAG
TAGCGNTA	TAGCGTAA
TATCGAGG	TAATCGAG
TATCGAGT	TAATCGAG
TATCGAGN	TAATCGAG
TATCGATA	GATCGATA
TATCGGCA	TTCGGCAG
TAGCTCAG	CAGCTCAG
TCGGCAGC	TTCGGCAG
TCGGCAGA	TTCGGCAG
TCGGCAGG	TTCGGCAG
TAGCTAAC	TAGCGTAA
TCGGCAGT	TTCGGCAG
TAGCTAAA	TAGCGTAA
TCGGCAGN	TTCGGCAG
TAGCTAAG	TAGCGTAA
TAGCTAAT	TAGCGTAA
TAGCTAAN	TAGCGTAA
TATCGTAA	TAGCGTAA
TAGCTATG	TAGTATGG
TCGGCGCA	TGGCGCAT
TAGCTGTA	TAGCGTAA
TCGGCTAG	TCCGCTAG
TAGCTTAA	TAGCGTAA
TATCTACA	TTCTACAT
TATTCCTG	ATTCCTGC
TATAGGAT	TAAAGGAT
TGATCCCC	TGATCCCT
TGATCCCA	TGATCCCT
TGATCCCG	TGATCCCT
TGATCCCT	TGATCCCT
TGATCCCN	TGATCCCT
TGATCCAC	TGATCCCT
TATTCAAG	ATTCAAGG
TGATCCAT	TGATCCCT
TATCTGAC	ATCTGACC
TGATCCGC	TGATCCCT
TGATCCGT	TGATCCCT
TGATCCTC	TGATCCCT
TGATCCTA	TGATCCCT
TGATCCTG	TGATCCCT
TGATCCTT	TGATCCCT
TGATCCTN	TGATCCCT
TGATCCNC	TGATCCCT
TGATCCNT	TGATCCCT
TGATCACC	TGATCCCT
TGATCACT	TGATCCCT
TATTCGAG	TAATCGAG
TGATCGCC	TGATCCCT
TCNTGGAG	TCTTGGAG
TGATCGCT	TGATCCCT
TGATCGAG	TAATCGAG
TGATCGAT	GATCGATA
TGCGCACT	TGCGGACT
TAGCNGTA	TAGCGTAA
TGATCTCC	TGATCCCT
TGCGCATC	TGGCGCAT
TGCGCATA	TGGCGCAT
TGCGCATG	TGGCGCAT
TGATCTCT	TGATCCCT
TGCGCATT	TGGCGCAT
TGCGCATN	TGGCGCAT
TAGCNTAA	TAGCGTAA
TATATCGA	TAATCGAG
TGCGCGCA	TGGCGCAT
TGATCTGT	TGAACTGT
TGCGCGAC	TGCGGACT
TGATCNCC	TGATCCCT
TGATCNCT	TGATCCCT
TATATAAC	ATATAACT
TATATATC	TAATATAT
TATATATA	TAATATAT
TATATATG	TAATATAT
TATATATT	TAATATAT
TGCGCTAG	TCCGCTAG
TATATATN	TAATATAT
TCNTTCAC	TCCTTCAC
TGATACCC	TGATCCCT
TGATACCT	TGATCCCT
TATATGGC	TAGTATGG
TATATGGA	TAGTATGG
TATATGGG	TAGTATGG
TATATGGT	TAGTATGG
TATATGGN	TAGTATGG
TGATACTG	TGAACTGT
TGGTGCAT	TGGCGCAT
TATATTTC	ATATTTCC
TATTATAT	TAATATAT
TCNTTGGA	TCTTGGAG
TATTATGG	TAGTATGG
TAGACGTA	TAGCGTAA
TANAAGGA	TAAAGGAT
TGATATAT	TAATATAT
TGCGACTC	TGCGGACT
TGCGACTA	TGCGGACT
TGCGACTG	TGCGGACT
TGCGACTT	TGCGGACT
TGGTGGGG	TGTGGGGT
TGCGACTN	TGCGGACT
TGGTGGTT	CGGTGGTT
TGCGAACT	TGCGGACT
TGATGCCC	TGATCCCT
TGATGCCT	TGATCCCT
TGCGAGAC	TGCGGACT
TATTGGAG	TCTTGGAG
TATTGTGG	TTTGTGGC
TGATGGGG	TGTGGGGT
TANAGGAT	TAAAGGAT
TGCGGCCT	TGCGGACT
TGCGGCAC	TGCGGACT
TGCGGCAG	TTCGGCAG
TGCGGCTC	TGCGGACT
TGCGGCTA	TGCGGACT
TGCGGCTG	TGCGGACT
TGCGGCTT	TGCGGACT
TGCGGCTN	TGCGGACT
TATTTCCC	ATATTTCC
TATTTCCA	ATATTTCC
TATTTCCG	ATATTTCC
TATTTCCT	ATATTTCC
TATTTCCN	ATATTTCC
TGCGGACC	TGCGGACT
TGCGGACA	TGCGGACT
TGCGGACG	TGCGGACT
TGCGGACT	TGCGGACT
TGCGGACN	TGCGGACT
TGCGGAAC	TGCGGACT
TGCGGAAG	CGCGGAAG
TGCGGAAT	TGCGGACT
TGCGGAGC	TGCGGACT
TGCGGAGT	TGCGGACT
TGCGGATC	TGCGGACT
TGCGGATA	TGCGGACT
TGGTTTGA	TGTTTTGA
TGCGGATG	TGCGGACT
TGCGGATT	TGCGGACT
TGCGGATN	TGCGGACT
TGCGGANC	TGCGGACT
TGGTTTTG	TGTTTTGA
TGCGGANT	TGCGGACT
TATGCACG	TTGCACGA
TGCGGGCT	TGCGGACT
TGCGGGAC	TGCGGACT
TGCGGGGT	TGTGGGGT
TANATCGA	TAATCGAG
TGCGGTCT	TGCGGACT
TGCGGTAC	TGCGGACT
TANGTATG	TAGTATGG
TATGCGTA	TAGCGTAA
TANATATA	TAATATAT
TGCGGNCT	TGCGGACT
TATTTTGA	TGTTTTGA
TGCGGNAC	TGCGGACT
TGCGTACT	TGCGGACT
TGCGTAAC	TAGCGTAA
TGCGTAAA	TAGCGTAA
TGCGTAAG	TAGCGTAA
TGCGTAAT	TAGCGTAA
TGCGTAAN	TAGCGTAA
TGCGTAGG	GCGTAGGT
TGCGTGAC	TGCGGACT
TGCGTTTC	AGCGTTTC
TATGAGTT	TTGAGTTA
TGGNCGCA	TGGCGCAT
TGCGNACT	TGCGGACT
TGCGNGAC	TGCGGACT
TANTCGAG	TAATCGAG
TATGGGGT	TGTGGGGT
TGCTCCCT	TGATCCCT
TGCTCCGG	TCTCCGGG
TATGGTCA	AATGGTCA
TGCTCGCC	GCTCGCCC
TGNCGCAT	TGGCGCAT
TGACGCAT	TGGCGCAT
TGGNGCAT	TGGCGCAT
TANGCGTA	TAGCGTAA
TGNCGGAC	TGCGGACT
TGCTACAT	TTCTACAT
TGACGGAC	TGCGGACT
TANTATAT	TAATATAT
TANTATGG	TAGTATGG
TGACTCCC	TGATCCCT
TGACTAAC	GACTAACT
TGCTGACT	TGCGGACT
TGACTGTC	TGAACTGT
TGACTGTA	TGAACTGT
TGACTGTG	TGAACTGT
TGACTGTT	TGAACTGT
TGACTGTN	TGAACTGT
TGCTGGAC	TGCGGACT
TGCTGGGG	TGTGGGGT
TGATTCCC	TGATCCCT
TGATTCCT	TGATCCCT
TAGAACTG	TGAACTGT
TAGAAACC	TCAGAAAC
TAGAAACA	TCAGAAAC
TAGAAACG	TCAGAAAC
TAGAAACT	TCAGAAAC
TAGAAACN	TCAGAAAC
TAGAAATC	AAGAAATC
TGATTATT	CGATTATT
TGCTTCAC	TCCTTCAC
TAGAAGGA	TAAAGGAT
TAGAAGGG	GAGAAGGG
TGATTTGA	TGTTTTGA
TAGAATGG	TAGTATGG
TGATTTTG	TGTTTTGA
TGCTTGGA	TCTTGGAG
TGATNCCC	TGATCCCT
TAGAGCCG	GAGAGCCG
TGATNCCT	TGATCCCT
TGCTTTAA	GCTTTAAA
TGCTTTGA	TGTTTTGA
TGCTTTTG	TGTTTTGA
TTCAACCC	TTAACCCC
TTCAACAT	TTCTACAT
TTCAACGA	TCCAACGA
TGAACCCC	TTAACCCC
TGAACCCT	TGATCCCT
TGAACCGT	TGAACTGT
TGAACCTG	TGAACTGT
TAGAGGAT	TAAAGGAT
TGTCCCTC	TGATCCCT
TGTCCCTA	TGATCCCT
TGTCCCTG	TGATCCCT
TGAACAGT	TGAACTGT
TTCAAGCC	GTCAAGCC
TGTCCCTT	TGATCCCT
TGTCCCTN	TGATCCCT
TGAACATG	TGAACTGT
TTCAAGGC	ATTCAAGG
TTCAAGGA	ATTCAAGG
TTCAAGGG	ATTCAAGG
TTCAAGGT	ATTCAAGG
TGCNGACT	TGCGGACT
TTCAAGGN	ATTCAAGG
TAGAGTAA	TAGCGTAA
TGNACTGT	TGAACTGT
TGAACGGT	TGAACTGT
TAGAGTTA	TTGAGTTA
TGAACGTC	TGAACTGT
TGAACGTA	TGAACTGT
TGAACGTG	TGAACTGT
TGAACGTT	TGAACTGT
TGAACGTN	TGAACTGT
TGAACTCG	TGAACTGT
TGAACTCT	TGAACTGT
TGAACTAG	TGAACTGT
TGTCCGGG	TCTCCGGG
TGAACTAT	TGAACTGT
TGCNGGAC	TGCGGACT
TGAACTGC	TGAACTGT
TGAACTGA	TGAACTGT
TGAACTGG	TGAACTGT
TGAACTGT	TGAACTGT
TGAACTGN	TGAACTGT
TGAACTTC	TGAACTGT
TGAACTTA	TGAACTGT
TGAACTTG	TGAACTGT
TGAACTTT	TGAACTGT
TGAACTTN	TGAACTGT
TGAACTNG	TGAACTGT
TGAACTNT	TGAACTGT
TAGATCCC	TGATCCCT
TGANCCCT	TGATCCCT
TGGCACAT	TGGCGCAT
TAGATCGA	TAATCGAG
TGGCACGA	TTGCACGA
TGAACNGT	TGAACTGT
TGNAACTG	TGAACTGT
TGAACNTG	TGAACTGT
TTCAGCAG	TTCGGCAG
TAGATATA	TAATATAT
TAGATATG	TAGTATGG
TGAAACTG	TGAACTGT
TTCAGAAA	TCAGAAAC
TGGCAGCA	TGGCGCAT
TAGATGGC	TAGTATGG
TAGATGGA	TAGTATGG
TAGATGGG	TAGTATGG
TAGATGGT	TAGTATGG
TAGATGGN	TAGTATGG
TTCAGGCA	TTCGGCAG
TTCAGGTC	TCAGGTCT
TGTCAAGC	GTCAAGCC
TGAAAGGA	TAAAGGAT
TTCAGTTA	TTGAGTTA
TGANCTGT	TGAACTGT
TGAAATGT	TGAACTGT
TGGCGCCA	TGGCGCAT
TGGCGCCT	TGGCGCAT
TGGCGCAC	TGGCGCAT
TGGCGCAA	TGGCGCAT
TGGCGCAG	TGGCGCAT
TGGCGCAT	TGGCGCAT
TGGCGCAN	TGGCGCAT
TGGCGCGA	TGGCGCAT
TGGCGCGT	TGGCGCAT
TGGCGCTC	TGGCGCAT
TGGCGCTA	TGGCGCAT
TGGCGCTG	TGGCGCAT
TGGCGCTT	TGGCGCAT
TGGCGCTN	TGGCGCAT
TGGCGCNA	TGGCGCAT
TGGCGCNT	TGGCGCAT
TGGCGACA	TGGCGCAT
TTAGTAAG	TTGTAAGC
TGGCGAAT	TGGCGCAT
TTCATACA	TTCTACAT
TGANACTG	TGAACTGT
TTAGTATG	TAGTATGG
TGAAGCTG	TGAACTGT
TGGCGATC	TGGCGCAT
TGGCGATA	TGGCGCAT
TGGCGATG	TGGCGCAT
TGGCGATT	TGGCGCAT
TGGCGATN	TGGCGCAT
TGTCGCAT	TGGCGCAT
TGGCGGCA	TGGCGCAT
TGGCGGAC	TGCGGACT
TTAGTGGC	TTTGTGGC
TGGCGGAT	TGGCGCAT
TTAGTTAC	TTGAGTTA
TTAGTTAA	TTGAGTTA
TGGCGTCA	TGGCGCAT
TTAGTTAG	TTGAGTTA
TTAGTTAT	TTGAGTTA
TGAAGGAT	TAAAGGAT
TTAGTTAN	TTGAGTTA
TGGCGTAA	TAGCGTAA
TGGCGTAT	TGGCGCAT
TGTCGGCA	TTCGGCAG
TGTCGGAC	TGCGGACT
TGGCGNCA	TGGCGCAT
TGTCGGGG	TGTGGGGT
TGTCGGGT	TGTGGGGT
TGAAGTGT	TGAACTGT
TGGCGNAT	TGGCGCAT
TAGGCCCC	CTAGGCCC
TAGGCCCA	CTAGGCCC
TAGGCCCG	CTAGGCCC
TAGGCCCT	CTAGGCCC
TAGGCCCN	CTAGGCCC
TGTCGTAC	ATGTCGTA
TGTCGTAA	ATGTCGTA
TGTCGTAG	ATGTCGTA
TGTCGTAT	ATGTCGTA
TGTCGTAN	ATGTCGTA
TGGCTCAT	TGGCGCAT
TGAATCCC	TGATCCCT
TGAATCCT	GAATCCTC
TGAATCGA	TAATCGAG
TAGGCGCA	TGGCGCAT
TGAATCTG	TGAACTGT
TAGGCGTA	TAGCGTAA
TGGCTGCA	TGGCGCAT
TGAATATA	TAATATAT
TGTCTACA	TTCTACAT
TGAATGTC	TGAACTGT
TGAATGTA	TGAACTGT
TGAATGTG	TGAACTGT
TGAATGTT	TGAACTGT
TGAATGTN	TGAACTGT
TGACCCCT	TGATCCCT
TGACCCGG	CGACCCGG
TGACCCTC	TGATCCCT
TGACCCTA	TGATCCCT
TGACCCTG	TGATCCCT
TGAATTGT	TGAACTGT
TGACCCTT	TGATCCCT
TGACCCTN	TGATCCCT
TTATCCCC	TTAACCCC
TGACCACC	TACCACCA
TTATCCCT	TGATCCCT
TGTCTTGA	TGTTTTGA
TGGCNCAT	TGGCGCAT
TGTCTTTG	TGTTTTGA
TTCGCCAG	TTCGGCAG
TTCGCACG	TTGCACGA
TGANTCCC	TGATCCCT
TTCGCAGC	TTCGGCAG
TTCGCAGA	TTCGGCAG
TGAANCTG	TGAACTGT
TTCGCAGG	TTCGGCAG
TTCGCAGT	TTCGGCAG
TTCGCAGN	TTCGGCAG
TTATCGAG	TAATCGAG
TGGCNGCA	TGGCGCAT
TTCGCGCA	TTCGGCAG
TGACCTGT	TGAACTGT
TAGGATGG	TAGTATGG
TTCGCTAG	TCCGCTAG
TGAANTGT	TGAACTGT
TAGGGCCA	AGGGCCAA
TTATACCC	TTAACCCC
TGACACTG	TGAACTGT
TTATACAT	TTCTACAT
TTCGACAG	TTCGGCAG
TTCGACAT	TTCTACAT
TTATAACT	ATATAACT
TAGGGAGT	AAGGGAGT
TTATAAGC	TTGTAAGC
TGGACAAC	GTGGACAA
TGGACAAA	GTGGACAA
TGGACAAG	GTGGACAA
TGGACAAT	GTGGACAA
TGGACAAN	GTGGACAA
TGTACCCT	GTACCCTG
TTCGAGCA	TTCGGCAG
TGGACGCA	TGGCGCAT
TAGGGTCG	AGGGTCGG
TAGGGTAA	TAGCGTAA
TTCGAGTT	TTGAGTTA
TTATATAT	TAATATAT
TGGACTGT	TGAACTGT
TGTACGGA	GTACGGAT
TGTTATGA	TGTTTTGA
TGTTATTG	TGTTTTGA
TGTATCCC	TGATCCCT
TAGGTCTC	TCAGGTCT
TAGGTCTA	TCAGGTCT
TAGGTCTG	TCAGGTCT
TTCGGCCA	TTCGGCAG
TAGGTCTT	TCAGGTCT
TTCGGCCG	TTCGGCAG
TAGGTCTN	TCAGGTCT
TGTACTGT	TGAACTGT
TTCGGCAC	TTCGGCAG
TTCGGCAA	TTCGGCAG
TTCGGCAG	TTCGGCAG
TTCGGCAT	TTCGGCAG
TTCGGCAN	TTCGGCAG
TTCGGCGC	TTCGGCAG
TTCGGCGA	TTCGGCAG
TTCGGCGG	TTCGGCAG
TTCGGCGT	TTCGGCAG
TAGGTAAC	TAGCGTAA
TTCGGCGN	TTCGGCAG
TAGGTAAA	TAGCGTAA
TAGGTAAG	TAGCGTAA
TTCGGCTA	TTCGGCAG
TAGGTAAT	TAGCGTAA
TTCGGCTG	TTCGGCAG
TAGGTAAN	TAGCGTAA
TGGAACTG	TGAACTGT
TTCGGCNA	TTCGGCAG
TTCGGCNG	TTCGGCAG
TAGGTATG	TAGTATGG
TTCGGACA	TTCGGCAG
TGTATACG	CGTATACG
TTCGGACT	TGCGGACT
TTCGGAAG	TTCGGCAG
TTCGGAGC	TTCGGCAG
TTCGGAGA	TTCGGCAG
TTCGGAGG	TTCGGCAG
TTCGGAGT	TTCGGCAG
TTCGGAGN	TTCGGCAG
TGTAACCC	TTAACCCC
TTCGGGCA	TTCGGCAG
TTCGGGAG	TTCGGCAG
TGTAACTG	TGAACTGT
TGGCCCAT	TGGCGCAT
TGTATGGC	TAGTATGG
TGTATGGA	TAGTATGG
TGTATGGG	TAGTATGG
TGTATGGT	TAGTATGG
TGTATGGN	TAGTATGG
TGTTGGAG	TCTTGGAG
TTCGGTCA	TTCGGCAG
TTATGTGG	TTTGTGGC
TGTTGGGG	TGTGGGGT
TGTTGGGT	TGTGGGGT
TTCGGTAG	TTCGGCAG
TGGCCATC	TGGCGCAT
TGTAAGCC	TTGTAAGC
TGGCCATA	TGGCGCAT
TGTAAGCA	TTGTAAGC
TGTATTGA	TGTTTTGA
TGGCCATG	TGGCGCAT
TGTAAGCG	TTGTAAGC
TGGCCATT	TGGCGCAT
TGTAAGCT	TTGTAAGC
TGGCCATN	TGGCGCAT
TGTAAGCN	TTGTAAGC
TGTATTTG	TGTTTTGA
TTCGGNCA	TTCGGCAG
TGTTGTGA	TGTTTTGA
TGTTGTGG	TTTGTGGC
TTCGGNAG	TTCGGCAG
TGTTGTTG	TGTTTTGA
TGGCCGCA	TGGCGCAT
TTCGTCAG	TTCGGCAG
TGGAGCAT	TGGCGCAT
TGTTTCCC	GTTTCCCG
TTCGTACA	TTCTACAT
TGTTTCGA	TGTTTTGA
TTCGTAAG	TTGTAAGC
TGTTTCTG	TGTTTTGA
TTCGTGCA	TTCGGCAG
TGTTTAGA	TGTTTTGA
TGTTTATG	TGTTTTGA
TTCGTGGC	TTTGTGGC
TTATTTCC	ATATTTCC
TGTTTGCA	GTTTGCAT
TGTTTGAC	TGTTTTGA
TGTTTGAA	TGTTTTGA
TGTTTGAG	TGTTTTGA
TGTTTGAT	TGTTTTGA
TGTTTGAN	TGTTTTGA
TGTTTGGA	TGTTTTGA
TGTTTGTG	TGTTTTGA
TGTTTTCA	TGTTTTGA
TGTTTTCG	TGTTTTGA
TGGAGTTA	TTGAGTTA
TGTTTTAC	TGTTTTGA
TGTTTTAA	TGTTTTGA
TGTTTTAG	TGTTTTGA
TGTTTTAT	TGTTTTGA
TGTTTTAN	TGTTTTGA
TGTTTTGC	TGTTTTGA
TGTTTTGA	TGTTTTGA
TGTTTTGG	TGTTTTGA
TGTAGGGG	TGTGGGGT
TGTTTTGT	TGTTTTGA
TGTAGGGT	TGTGGGGT
TGTTTTGN	TGTTTTGA
TGTTTTTA	TGTTTTGA
TGTTTTTG	TGTTTTGA
TGTTTTNA	TGTTTTGA
TGTTTTNG	TGTTTTGA
TGTTTNGA	TGTTTTGA
TGGATCCC	TGATCCCT
TGTTTNTG	TGTTTTGA
TTGNCACG	TTGCACGA
TTCGNCAG	TTCGGCAG
TGTGCACG	TTGCACGA
TGGATTCC	CGGATTCC
TGTGCGCA	TGGCGCAT
TTCGNGCA	TTCGGCAG
TGTGCGGG	TGTGGGGT
TGTGCGGT	TGTGGGGT
TGTTNTGA	TGTTTTGA
TGTTNTTG	TGTTTTGA
TTANCCCC	TTAACCCC
TGNTCCCT	TGATCCCT
TTGNACGA	TTGCACGA
TTGNAAGC	TTGTAAGC
TTCTCCAT	TTCTACAT
TTCTCCGG	TCTCCGGG
TGNATCCC	TGATCCCT
TTGNAGTT	TTGAGTTA
TTCTCACA	TTCTACAT
TTCTCATC	TTCTACAT
TTCTCATA	TTCTACAT
TTCTCATG	TTCTACAT
TTCTCATT	TTCTACAT
TTCTCATN	TTCTACAT
TGTGAGGG	TGTGGGGT
TGTGAGGT	TGTGGGGT
TGTGAGTT	TTGAGTTA
TTCTCTAC	CTTCTCTA
TTCTCTAA	CTTCTCTA
TTCTCTAG	CTTCTCTA
TTCTCTAT	CTTCTCTA
TTCTCTAN	CTTCTCTA
TTCTACCA	TTCTACAT
TTCTACCT	TTCTACAT
TTCTACAC	TTCTACAT
TTCTACAA	TTCTACAT
TTCTACAG	TTCTACAT
TTCTACAT	TTCTACAT
TTCTACAN	TTCTACAT
TTCTACGA	TTCTACAT
TTNCGGCA	TTCGGCAG
TTCTACGT	TTCTACAT
TTCTACTC	TTCTACAT
TTCTACTA	TTCTACAT
TTCTACTG	TTCTACAT
TTCTACTT	TTCTACAT
TTCTACTN	TTCTACAT
TTCTACNA	TTCTACAT
TTCTACNT	TTCTACAT
TGTGGCGG	TGTGGGGT
TTCTAACA	TTCTACAT
TGTGGCGT	TGTGGGGT
TTCTAAAT	TTCTACAT
TTCTAAGC	TTGTAAGC
TTCTAATC	TTCTACAT
TTCTAATA	TTCTACAT
TGTGGACA	GTGGACAA
TTCTAATG	TTCTACAT
TTCTAATT	TTCTACAT
TGTGGACT	TGCGGACT
TTCTAATN	TTCTACAT
TTGNGTTA	TTGAGTTA
TTCTAGCA	TTCTACAT
TGTGGAGG	TGTGGGGT
TGTGGAGT	TGTGGGGT
TTCTAGAT	TTCTACAT
TGTGGGCG	TGTGGGGT
TGTGGGCT	TGTGGGGT
TGTGGGAG	TGTGGGGT
TTCTATCA	TTCTACAT
TGTGGGAT	TGTGGGGT
TGTGGGGC	TGTGGGGT
TGTGGGGA	TGTGGGGT
TGTGGGGG	TGTGGGGT
TGTGGGGT	TGTGGGGT
TTCTATAT	TTCTACAT
TGTGGGGN	TGTGGGGT
TGTGGGTC	TGTGGGGT
TGTGGGTA	TGTGGGGT
TGTGGGTG	TGTGGGGT
TGTGGGTT	TGTGGGGT
TGTGGGTN	TGTGGGGT
TGTGGGNG	TGTGGGGT
TGTGGGNT	TGTGGGGT
TTCTANCA	TTCTACAT
TTCTANAT	TTCTACAT
TGTGGTGG	TGTGGGGT
TTGNTAAG	TTGTAAGC
TGTGGTGT	TGTGGGGT
TTNCTACA	TTCTACAT
TTCTGCAG	TTCGGCAG
TTCTGCAT	TTCTACAT
TGTGGNGG	TGTGGGGT
TGTGGNGT	TGTGGGGT
TTCTGACC	ATCTGACC
TTCTGACA	TTCTACAT
TGNTGGGG	TGTGGGGT
TGTNGGGG	TGTGGGGT
TGTNGGGT	TGTGGGGT
TTCTGGCA	TTCGGCAG
TGTGTAAG	TTGTAAGC
TGCCCCTT	GCCCCTTT
TTCTGTGG	TTTGTGGC
TGTGTGGC	TTTGTGGC
TGTGTGGG	TGTGGGGT
TGTGTGGT	TGTGGGGT
TGTGTTGA	TGTTTTGA
TGTGTTTG	TGTTTTGA
TTCTTCAC	TCCTTCAC
TGNGCGCA	TGGCGCAT
TTCTTCAT	TTCTACAT
TTCTTACA	TTCTACAT
TGCCACCA	TACCACCA
TGNTTTGA	TGTTTTGA
TGTNTTGA	TGTTTTGA
TGNTTTTG	TGTTTTGA
TTCTTGGA	TCTTGGAG
TGTNTTTG	TGTTTTGA
TGCCAACG	TCCAACGA
TTTCCCGC	GTTTCCCG
TTTCCCGA	GTTTCCCG
TTNACCCC	TTAACCCC
TTTCCCGG	GTTTCCCG
TTTCCCGT	GTTTCCCG
TTTCCCGN	GTTTCCCG
TTAACCCC	TTAACCCC
TTAACCCA	TTAACCCC
TTAACCCG	TTAACCCC
TTAACCCT	TTAACCCC
TTAACCCN	TTAACCCC
TTAACCAC	TTAACCCC
TTAACCGC	TTAACCCC
TTAACCTC	TTAACCCC
TTAACCNC	TTAACCCC
TGTGNGGG	TGTGGGGT
TGTGNGGT	TGTGGGGT
TTAACACC	TTAACCCC
TTCTNCAT	TTCTACAT
TTTCCGGG	TCTCCGGG
TTAACGCC	TTAACCCC
TTCTNACA	TTCTACAT
TTTCCTGC	ATTCCTGC
TTAACTCC	TTAACCCC
TGCCGCAT	TGGCGCAT
TTAACTGT	TGAACTGT
TGTTCCCT	TGATCCCT
TGCCGCTA	TCCGCTAG
TTAACNCC	TTAACCCC
TGCCGACT	TGCGGACT
TTTCACGA	TTGCACGA
TTNAACCC	TTAACCCC
TTAAACCC	TTAACCCC
TGCCGGAC	TGCGGACT
TGNGGACT	TGCGGACT
TTTCAAGG	ATTCAAGG
TGCCGGGT	GCCGGGTC
TGNGGGGT	TGTGGGGT
TTAAAGGA	TAAAGGAT
TGTTCTGA	TGTTTTGA
TGTTCTTG	TGTTTTGA
TTCNGCAG	TTCGGCAG
TTAAGCCC	TTAACCCC
TTAAGAAC	CTAAGAAC
TTTCGGCA	TTCGGCAG
TTCNGGCA	TTCGGCAG
TTCNACAT	TTCTACAT
TTAAGGAT	TAAAGGAT
TTTCGTGG	TTTGTGGC
TTNAGTTA	TTGAGTTA
TGGGCCAA	AGGGCCAA
TTAAGTTA	TTGAGTTA
TGGGCATC	TGGCGCAT
TGGGCATA	TGGCGCAT
TGGGCATG	TGGCGCAT
TGGGCATT	TGGCGCAT
TTAATCCC	TTAACCCC
TGGGCATN	TGGCGCAT
TGGGCGCA	TGGCGCAT
TTAATCGA	TAATCGAG
TTCNTACA	TTCTACAT
TTAATATA	TAATATAT
TTTCTCTA	CTTCTCTA
TTAATGCC	CTTAATGC
TTAATGCA	CTTAATGC
TTAATGCG	CTTAATGC
TTAATGCT	CTTAATGC
TTAATGCN	CTTAATGC
TTTCTACA	TTCTACAT
TTTCTGGC	TTTGTGGC
TGGGACTC	TGCGGACT
TGGGACTA	TGCGGACT
TGGGACTG	TGCGGACT
TGGGACTT	TGCGGACT
TGGGACTN	TGCGGACT
TTANACCC	TTAACCCC
TTAANCCC	TTAACCCC
TTGCNCGA	TTGCACGA
TTGCNACG	TTGCACGA
TGGGATCC	CTGGGATC
TGGGATCA	CTGGGATC
TGGGATCG	CTGGGATC
TGGGATCT	CTGGGATC
TGGGATCN	CTGGGATC
TNCGCTAG	TCCGCTAG
TGGGGCAT	TGGCGCAT
TGGGGACT	TGCGGACT
TTGACCCC	TTAACCCC
TTAGCCCC	TTAACCCC
TTACCCCC	TTAACCCC
TTTACCCC	TTAACCCC
TTACCCCA	TTAACCCC
TTACCCCG	TTAACCCC
TTACCCCT	TTAACCCC
TTACCCCN	TTAACCCC
TGGGGGGT	TGTGGGGT
TTTACCAA	CTTACCAA
TTGACACG	TTGCACGA
TGGGGGTC	TGTGGGGT
TGGGGGTA	TGTGGGGT
TGGGGGTG	TGTGGGGT
TGGGGGTT	TGTGGGGT
TGGGGGTN	TGTGGGGT
TTACCCTG	GTACCCTG
TTAGCACG	TTGCACGA
TTACCACC	TACCACCA
TTACCAAC	CTTACCAA
TTACCAAA	CTTACCAA
TTGACGAC	TTGCACGA
TTGACGAA	TTGCACGA
TTACCAAG	CTTACCAA
TTGACGAG	TTGCACGA
TTACCAAT	CTTACCAA
TTGACGAT	TTGCACGA
TTTACATC	TTCTACAT
TTACCAAN	CTTACCAA
TTGACGAN	TTGCACGA
TTTACATA	TTCTACAT
TTTACATG	TTCTACAT
TTTACATT	TTCTACAT
TTTACATN	TTCTACAT
TNATATAT	TAATATAT
TTAGCATT	CTAGCATT
TTGACGTT	TTGAGTTA
TTAGCGTA	TAGCGTAA
TTGACTTA	TTGAGTTA
TGGGTCGG	AGGGTCGG
TNCGGCAG	TTCGGCAG
TNCGGACT	TGCGGACT
TTGAACCC	TTAACCCC
TTGAACGA	TTGCACGA
TTTAACCC	TTAACCCC
TTGAACTG	TGAACTGT
TTAGACCC	TTAACCCC
TTGAAAGC	TTGTAAGC
TTACACCC	TTAACCCC
TTACACGA	TTGCACGA
TTGAAGCC	TTGTAAGC
TTGAAGCA	TTGTAAGC
TTGAAGCG	TTGTAAGC
TTGAAGCT	TTGTAAGC
TTGAAGCN	TTGTAAGC
TTTAAGCC	TTGTAAGC
TTTAAGCA	TTGTAAGC
TTTAAGCG	TTGTAAGC
TTTAAGCT	TTGTAAGC
TTTAAGCN	TTGTAAGC
TTGAAGTT	TTGAGTTA
TTAGAAAC	TCAGAAAC
TTGAATTA	TTGAGTTA
TTTAATGC	CTTAATGC
TTAGAGTT	TTGAGTTA
TTGAGCTA	TTGAGTTA
TTGAGCTT	TTGAGTTA
TTGAGATA	TTGAGTTA
TTGAGATT	TTGAGTTA
TTAGGCCC	CTAGGCCC
TTAGGCAG	TTCGGCAG
TTGAGGTA	TTGAGTTA
TTGAGGTT	TTGAGTTA
TTGAGTCA	TTGAGTTA
TTGAGTCT	TTGAGTTA
TTGAGTAC	TTGAGTTA
TTGAGTAA	TTGAGTTA
TTGAGTAG	TTGAGTTA
TTGAGTAT	TTGAGTTA
TTGAGTAN	TTGAGTTA
TTGAGTGA	TTGAGTTA
TTGAGTGT	TTGAGTTA
TGGTCCCT	TGATCCCT
TTGAGTTC	TTGAGTTA
TTGAGTTA	TTGAGTTA
TTGAGTTG	TTGAGTTA
TTTAGTGG	TTTGTGGC
TTGAGTTT	TTGAGTTA
TTGAGTTN	TTGAGTTA
TTGAGTNA	TTGAGTTA
TTTAGTTA	TTGAGTTA
TTGAGTNT	TTGAGTTA
TTACGGCA	TTCGGCAG
TTACGGAT	GTACGGAT
TTGAGNTA	TTGAGTTA
TTGAGNTT	TTGAGTTA
TTGATCCC	TGATCCCT
TTAGGTCT	TCAGGTCT
TGGTCGCA	TGGCGCAT
TTGATAAG	TTGTAAGC
TTTATGGC	TTTGTGGC
TTGATGTT	TTGAGTTA
TTGATTAC	TTGAGTTA
TTGATTAA	TTGAGTTA
TTGATTAG	TTGAGTTA
TTGATTAT	TTGAGTTA
TTGATTAN	TTGAGTTA
TTGATTTA	TTGAGTTA
TTACTACA	TTCTACAT
TTGCCCGA	TTGCACGA
TNCTCCGG	TCTCCGGG
TTGCCACG	TTGCACGA
TGGTAAGC	TTGTAAGC
TTGCCGAC	TTGCACGA
TTGCCGAA	TTGCACGA
TTGCCGAG	TTGCACGA
TTGCCGAT	TTGCACGA
TTGCCGAN	TTGCACGA
TGGTATGG	TAGTATGG
TTGANGTT	TTGAGTTA
TTGCACCA	TTGCACGA
TTGCACCG	TTGCACGA
TTGCACAC	TTGCACGA
TTGCACAA	TTGCACGA
TTGCACAG	TTGCACGA
TTGANTTA	TTGAGTTA
TTGCACAT	TTGCACGA
TTGCACAN	TTGCACGA
TTGCACGC	TTGCACGA
TNCTACAT	TTCTACAT
TTGCACGA	TTGCACGA
TTGCACGG	TTGCACGA
TTGCACGT	TTGCACGA
TTGCACGN	TTGCACGA
TTGCACTA	TTGCACGA
TTGCACTG	TTGCACGA
TTGCACNA	TTGCACGA
TTGCACNG	TTGCACGA
TTGCAACG	TTGCACGA
TTGCAAGC	TTGTAAGC
TTGCAAGA	TTGCACGA
TTGCAGCG	TTGCACGA
TTGCAGAC	TTGCACGA
TTGCAGAA	TTGCACGA
TTGCAGAG	TTGCACGA
TTGCAGAT	TTGCACGA
TTGCAGAN	TTGCACGA
TTGCAGGA	TTGCACGA
TTGCAGTT	TTGAGTTA
TTGGCACG	TTGCACGA
TTTGCACG	TTGCACGA
TTGGCAGC	TTCGGCAG
TTGCATCG	TTGCACGA
TTGGCAGA	TTCGGCAG
TTGGCAGG	TTCGGCAG
TTGGCAGT	TTCGGCAG
TTGGCAGN	TTCGGCAG
TTTGCATC	GTTTGCAT
TTTGCATA	GTTTGCAT
TTTGCATG	GTTTGCAT
TTTGCATT	GTTTGCAT
TTGCATGA	TTGCACGA
TTTGCATN	GTTTGCAT
TTGGCGCA	TGGCGCAT
TTGCANCG	TTGCACGA
TTTGCGGC	TTTGTGGC
TTGCANGA	TTGCACGA
TTTGCTGG	TTTGTGGC
TTGCGCAT	TGGCGCAT
TTGCGCGA	TTGCACGA
TTGCGACG	TTGCACGA
TTGGACAA	GTGGACAA
TTGCGGCA	TTCGGCAG
TTGGACGA	TTGCACGA
TTGCGGAC	TGCGGACT
TTTGAGGC	TTTGTGGC
TTGGAAGC	TTGTAAGC
TTTGAGTT	TTGAGTTA
TTGCGTAA	TAGCGTAA
TTGCGTTA	TTGAGTTA
TTTGATGG	TTTGTGGC
TTGGAGTT	TTGAGTTA
TTGCTCGA	TTGCACGA
TTTGGCAG	TTCGGCAG
TTGCTACA	TTCTACAT
TTGCTACG	TTGCACGA
TTGCTAAG	TTGTAAGC
TNCTTCAC	TCCTTCAC
TTTNGTGG	TTTGTGGC
TTTGGAGC	TCTTGGAG
TTTGGAGA	TCTTGGAG
TTTGGAGG	TCTTGGAG
TTTGGAGT	TCTTGGAG
TTTGGAGN	TCTTGGAG
TTTGGGCC	TTTGTGGC
TTTGGGCA	TTTGTGGC
TTTGGGCG	TTTGTGGC
TTTGGGCT	TTTGTGGC
TTTGGGCN	TTTGTGGC
TTTGGGGC	TTTGTGGC
TTTGGGGT	TGTGGGGT
TNCTTGGA	TCTTGGAG
TTTGGTGG	TTTGTGGC
TTCCACCA	TACCACCA
TTCCACAT	TTCTACAT
TTCCACGA	TTGCACGA
TTTNTGGC	TTTGTGGC
TTNGCACG	TTGCACGA
TTTGTCGC	TTTGTGGC
TTTGTCGG	TTTGTGGC
TTCCAACG	TCCAACGA
TNTCCGGG	TCTCCGGG
TTTGTAAG	TTGTAAGC
TTTGTAGC	TTTGTGGC
TTTGTAGG	TTTGTGGC
TTTGTGCC	TTTGTGGC
TTTGTGCA	TTTGTGGC
TTTGTGCG	TTTGTGGC
TTTGTGCT	TTTGTGGC
TTTGTGCN	TTTGTGGC
TTTGTGAC	TTTGTGGC
TTTGTGAG	TTTGTGGC
TTTGTGGC	TTTGTGGC
TTTGTGGA	TTTGTGGC
TTTGTGGG	TTTGTGGC
TTTGTGGT	TTTGTGGC
TTTGTGGN	TTTGTGGC
TTTGTGTC	TTTGTGGC
TTTGTGTG	TTTGTGGC
TTTGTGNC	TTTGTGGC
TTTGTGNG	TTTGTGGC
TTTGTTGC	TTTGTGGC
TTTGTTGG	TTTGTGGC
TTTGTNGC	TTTGTGGC
TTTGTNGG	TTTGTGGC
TTCCGCAG	TTCGGCAG
TTNGAGTT	TTGAGTTA
TTCCGCTA	TCCGCTAG
TTTGNGGC	TTTGTGGC
TTNGGCAG	TTCGGCAG
TTCCGGCA	TTCGGCAG
TTCCGGGC	TCTCCGGG
TTCCGGGA	TCTCCGGG
TTCCGGGG	TCTCCGGG
TTCCGGGT	TCTCCGGG
TTCCGGGN	TCTCCGGG
TTTGNTGG	TTTGTGGC
TNTCGGCA	TTCGGCAG
TTTTCCCG	GTTTCCCG
TTNCACGA	TTGCACGA
TTCCTACA	TTCTACAT
TTNGTAAG	TTGTAAGC
TTCCTGCC	ATTCCTGC
TTCCTGCA	ATTCCTGC
TTCCTGCG	ATTCCTGC
TTCCTGCT	ATTCCTGC
TTCCTGCN	ATTCCTGC
TNTCTACA	TTCTACAT
TTNGTGGC	TTTGTGGC
TTCCTTCA	TCCTTCAC
TTTTACAT	TTCTACAT
TNAATCGA	TAATCGAG
TTTTAAGC	TTGTAAGC
TNAATATA	TAATATAT
TTTTGCAT	GTTTGCAT
TTTTGGCC	TTTGTGGC
TTTTGGCA	TTTGTGGC
TTTTGGCG	TTTGTGGC
TTTTGGCT	TTTGTGGC
TTTTGGCN	TTTGTGGC
TTTTGGAG	TCTTGGAG
TTTTGTGG	TTTGTGGC
TTNTACAT	TTCTACAT
TTCACCCC	TTAACCCC
TTNTAAGC	TTGTAAGC
TTCACATC	TTCTACAT
TTCACATA	TTCTACAT
TTCACATG	TTCTACAT
TTCACATT	TTCTACAT
TTCACATN	TTCTACAT
TTCACGAC	TTGCACGA
TTCACGAA	TTGCACGA
TTCACGAG	TTGCACGA
TNAGCGTA	TAGCGTAA
TTCACGAT	TTGCACGA
TTCACGAN	TTGCACGA
TTTTTGAC	TGTTTTGA
TTTTTGAA	TGTTTTGA
TTTTTGAG	TGTTTTGA
TTTTTGAT	TGTTTTGA
TTTTTGAN	TGTTTTGA
TTTTTGGC	TTTGTGGC
TNTAACCC	TTAACCCC
NCCGGGTC	GCCGGGTC
TTTTTTGA	TGTTTTGA
NCCGGTAA	ACCGGTAA
TTGGGCAG	TTCGGCAG
TNAGAAAC	TCAGAAAC
TTGGGATC	CTGGGATC
TNACCACC	TACCACCA
TTNTGTGG	TTTGTGGC
TTGGGGTC	TGTGGGGT
TTGGGGTA	TGTGGGGT
TTGGGGTG	TGTGGGGT
TTGGGGTT	TGTGGGGT
TTGGGGTN	TGTGGGGT
TTGGGTTA	TTGAGTTA
NCCGTTGA	CCGTTGAG
TTGGTAAG	TTGTAAGC
TNGAGTTA	TTGAGTTA
TNAGGTCT	TCAGGTCT
TTGGTGGC	TTTGTGGC
TNGATCCC	TGATCCCT
TTGGTTAC	TTGAGTTA
TTGGTTAA	TTGAGTTA
TTGGTTAG	TTGAGTTA
TTGGTTAT	TTGAGTTA
TTGGTTAN	TTGAGTTA
TNAGTATG	TAGTATGG
NCCTCGAT	CCTCGATT
TTGTCACG	TTGCACGA
TTGTCAAG	TTGTAAGC
TTGTCAGC	TTGTAAGC
TNGCACGA	TTGCACGA
TTGTCGTA	ATGTCGTA
TNTGCACG	TTGCACGA
TNATCCCT	TGATCCCT
TNGGCGCA	TGGCGCAT
NCCTGCAA	CCTGCAAG
TTGTACAG	TTGTAAGC
TTGTACAT	TTCTACAT
TNATCGAG	TAATCGAG
TTGTACGC	TTGTAAGC
TTGTACGA	TTGCACGA
TTGTAACC	TTGTAAGC
TTGTAACA	TTGTAAGC
TTGTAACG	TTGTAAGC
TTGTAACT	TTGTAAGC
TTGTAACN	TTGTAAGC
TTGTAAAC	TTGTAAGC
TTGTAAAG	TTGTAAGC
TTGTAAGC	TTGTAAGC
TTGTAAGA	TTGTAAGC
TTGTAAGG	TTGTAAGC
TTGTAAGT	TTGTAAGC
TTGTAAGN	TTGTAAGC
TNGCGCAT	TGGCGCAT
TTGTAATC	TTGTAAGC
TTGTAATG	TTGTAAGC
TTGTAANC	TTGTAAGC
TTGTAANG	TTGTAAGC
TTGTAGCC	TTGTAAGC
TTGTAGCA	TTGTAAGC
TTGTAGCG	TTGTAAGC
TTGTAGCT	TTGTAAGC
TTGTAGCN	TTGTAAGC
NCCTGTCG	CCCTGTCG
TTGTAGAG	TTGTAAGC
TTGTAGGC	TTGTAAGC
TTGTAGTT	TTGAGTTA
TNGCGGAC	TGCGGACT
TTGTATAG	TTGTAAGC
TTGTATGC	TTGTAAGC
TTGTATGG	TAGTATGG
TNAACCCC	TTAACCCC
TNTGAGTT	TTGAGTTA
NCCTTCAC	TCCTTCAC
TNGCGTAA	TAGCGTAA
TTGTANAG	TTGTAAGC
TTGTANGC	TTGTAAGC
NCCTTAGT	GCCTTAGT
TTGTGAAG	TTGTAAGC
TTGTGAGC	TTGTAAGC
TNAACTGT	TGAACTGT
TTGTGGCC	TTTGTGGC
TTGTGGCA	TTTGTGGC
TTGTGGCG	TTTGTGGC
TTGTGGCT	TTTGTGGC
TTGTGGCN	TTTGTGGC
TTGTGGGG	TGTGGGGT
TNTGGGGT	TGTGGGGT
TTGTGTGG	TTTGTGGC
TTGTGTTA	TTGAGTTA
TNAAAGGA	TAAAGGAT
TTGTTAAG	TTGTAAGC
TNTGTAAG	TTGTAAGC
TTGTTAGC	TTGTAAGC
TNTGTGGC	TTTGTGGC
TTGTTTTG	TGTTTTGA
TNAAGGAT	TAAAGGAT
TTGTNAAG	TTGTAAGC
TTGTNAGC	TTGTAAGC
NCTCGCCC	GCTCGCCC
NCTCGATT	CCTCGATT
TNCCACCA	TACCACCA
TNCCAACG	TCCAACGA
TNGAACTG	TGAACTGT
TNCCGCTA	TCCGCTAG
TNCCTTCA	TCCTTCAC
TNTTGGAG	TCTTGGAG
TNTTGTGG	TTTGTGGC
TNTTTTGA	TGTTTTGA
NCCCCACT	CCCCACTG
NCTAAGAA	CTAAGAAC
TNCAACGA	TCCAACGA
NCCCCTAA	CCCCTAAA
NCCCCTTT	GCCCCTTT
NCCCACTG	CCCCACTG
NCAGAAAC	TCAGAAAC
TNCAGAAA	TCAGAAAC
NCTAGCAT	CTAGCATT
NCCCAGTT	CCCAGTTA
NCCCATCC	CCCATCCA
TNCAGGTC	TCAGGTCT
NCTAGGCC	CTAGGCCC
NCACGGCA	CACGGCAT
NCAGGTCT	TCAGGTCT
NCCCTAAA	CCCCTAAA
NCCCTGTC	CCCTGTCG
NCCCTTGG	ACCCTTGG
NCACTTCT	GCACTTCT
NCTGCAAG	CCTGCAAG
TNGTAAGC	TTGTAAGC
TNGTATGG	TAGTATGG
NCATCCGA	CATCCGAG
NACTAACT	GACTAACT
NCATCGTT	ACATCGTT
TNGTGGGG	TGTGGGGT
NCAACGCG	ACAACGCG
NCGGATTC	CGGATTCC
NCTGGGAT	CTGGGATC
NCAAAGCC	CAAAGCCA
TNGTTTTG	TGTTTTGA
NCAAAGTA	GCAAAGTA
NCAAATGG	CCAAATGG
NCGCGGAA	CGCGGAAG
NCGGTGGT	CGGTGGTT
NCGCTCCT	ACGCTCCT
NACTTGTA	AACTTGTA
NCAATTAG	ACAATTAG
NCTTCTCT	CTTCTCTA
NCTTACCA	CTTACCAA
NAGCAGGC	AAGCAGGC
NCTTAATG	CTTAATGC
NCGACCCG	CGACCCGG
NCGTAGGT	GCGTAGGT
NCGTATAC	CGTATACG
NCAGCTCA	CAGCTCAG
NAGCGTAA	TAGCGTAA
NAGCGTTT	AGCGTTTC
NAGCTCAG	CAGCTCAG
NCTTGGAG	TCTTGGAG
NCTTTAAA	GCTTTAAA
NAACCCGC	AACCCGCG
NCCAACGA	TCCAACGA
NAACCTTT	AAACCTTT
NCCAAATG	CCAAATGG
NACCCGCG	AACCCGCG
NCGATTAT	CGATTATT
NAACAAGT	AAACAAGT
NACCCTTG	ACCCTTGG
NACCACCA	TACCACCA
NCCAGTTA	CCCAGTTA
NCCATCCA	CCCATCCA
NACCGGTA	ACCGGTAA
NAACTTGT	AACTTGTA
NAAACCTT	AAACCTTT
NAAACAAG	AAACAAGT
NCCGCTAG	TCCGCTAG
NATATAAC	ATATAACT
NATGGTCA	AATGGTCA
NATATTTC	ATATTTCC
NACAACGC	ACAACGCG
NATGTCGT	ATGTCGTA
NACAATTA	ACAATTAG
NAATCCTC	GAATCCTC
NAAAGCCA	CAAAGCCA
NAATCGAG	TAATCGAG
NCGTTGAG	CCGTTGAG
NAAAGGAT	TAAAGGAT
NATTCCTG	ATTCCTGC
NAATATAT	TAATATAT
NATTCAAG	ATTCAAGG
NAATGGTC	AATGGTCA
NAAGCAGG	AAGCAGGC
NGGCGCAT	TGGCGCAT
NGCTTTAA	GCTTTAAA
NAGTATGG	TAGTATGG
NAGAAATC	AAGAAATC
NAGAAGGG	GAGAAGGG
NAAGAAAT	AAGAAATC
NAGAGCCG	GAGAGCCG
NAGTGTTC	GAGTGTTC
NAAGGGAG	AAGGGAGT
NAGTTGCC	AAGTTGCC
NAAGTTGC	AAGTTGCC
NCTCCGGG	TCTCCGGG
NGACTAAC	GACTAACT
NGCCGGGT	GCCGGGTC
NAGGGCCA	AGGGCCAA
NGACCCGG	CGACCCGG
NAGGGAGT	AAGGGAGT
NAGGGTCG	AGGGTCGG
NGCCTTAG	GCCTTAGT
NACATCGT	ACATCGTT
NGAACTGT	TGAACTGT
NGTATACG	CGTATACG
NGCACTTC	GCACTTCT
NGAATCCT	GAATCCTC
NGCAAAGT	GCAAAGTA
NACGCTCC	ACGCTCCT
NACGGCAT	CACGGCAT
NGTGGACA	GTGGACAA
NGATTATT	CGATTATT
NGTGGGGT	TGTGGGGT
NGCCCCTT	GCCCCTTT
NGTTTCCC	GTTTCCCG
NGTTTGCA	GTTTGCAT
NGAGAAGG	GAGAAGGG
NGTTTTGA	TGTTTTGA
NGAGAGCC	GAGAGCCG
NGGTGGTT	CGGTGGTT
NGGATTCC	CGGATTCC
NGAGTGTT	GAGTGTTC
NGGGCCAA	AGGGCCAA
NTGAACTG	TGAACTGT
NGATCCCT	TGATCCCT
NTGAGTTA	TTGAGTTA
NGATCGAT	GATCGATA
NTGATCCC	TGATCCCT
NTACCCTG	GTACCCTG
NTACCACC	TACCACCA
NTAACCCC	TTAACCCC
NATCCGAG	CATCCGAG
NGGGTCGG	AGGGTCGG
NTAAAGGA	TAAAGGAT
NATCGATA	GATCGATA
NTGGCGCA	TGGCGCAT
NTACGGAT	GTACGGAT
NTAAGAAC	CTAAGAAC
NTAATCGA	TAATCGAG
NATCTGAC	ATCTGACC
NTAATATA	TAATATAT
NTTGCACG	TTGCACGA
NTCAAGCC	GTCAAGCC
NTTGAGTT	TTGAGTTA
NTAGCATT	CTAGCATT
NTAGCGTA	TAGCGTAA
NTCAGAAA	TCAGAAAC
NTCAGGTC	TCAGGTCT
NGCGGACT	TGCGGACT
NGCGGAAG	CGCGGAAG
NGCGTAGG	GCGTAGGT
NTTGTAAG	TTGTAAGC
NTTGTGGC	TTTGTGGC
NGCGTTTC	AGCGTTTC
NTCCAACG	TCCAACGA
NTCCGCTA	TCCGCTAG
NTTTCCCG	GTTTCCCG
NGCTCGCC	GCTCGCCC
NTAGGCCC	CTAGGCCC
NTCCTTCA	TCCTTCAC
NTTTGCAT	GTTTGCAT
NTAGTATG	TAGTATGG
NTGGACAA	GTGGACAA
NTTTGTGG	TTTGTGGC
NTCGGCAG	TTCGGCAG
NTGGGATC	CTGGGATC
NTGCACGA	TTGCACGA
NTATAACT	ATATAACT
NTGCGGAC	TGCGGACT
NTGTCGTA	ATGTCGTA
NGTCAAGC	GTCAAGCC
NTGTAAGC	TTGTAAGC
NTATTTCC	ATATTTCC
NTGTGGGG	TGTGGGGT
NTGTTTTG	TGTTTTGA
NTTCCTGC	ATTCCTGC
NTTCAAGG	ATTCAAGG
NGTACCCT	GTACCCTG
NGTACGGA	GTACGGAT
NTCTCCGG	TCTCCGGG
NTCTACAT	TTCTACAT
NTCTGACC	ATCTGACC
NTCTTGGA	TCTTGGAG
NTTCGGCA	TTCGGCAG
NTTCTCTA	CTTCTCTA
NTTCTACA	TTCTACAT
NTTACCAA	CTTACCAA
NTTAACCC	TTAACCCC
NTTAATGC	CTTAATGC
